word	pronunciation
abandoned	əˈbændənd
abated	əˈbeɪtɪd
abbreviated	əˈbriviˌeɪtəd
abetted	əˈbɛtɪd
abhorred	əbˈhɔrd
abolished	əˈbɑlɪʃt
abounded	əˈbaʊndɪd
abridged	əˈbrɪʤd
abrogated	ˈæbrəˌgeɪtɪd
absented	æbˈsɛntɪd
absorbed	əbˈzɔrbd
abstracted	ˈæbˌstræktɪd
abused	əˈbjuzd
acceded	ækˈsidɪd
accelerated	ækˈsɛləˌreɪtɪd
accented	ˈæksɛntɪd
accentuated	ækˈsɛnʧəˌweɪtɪd
accepted	ækˈsɛptɪd
acclaimed	əˈkleɪmd
acclimatized	əˈkleɪməˌtaɪzd
accommodated	əˈkɑməˌdeɪtəd
accompanied	əˈkʌmpənid
accomplished	əˈkɑmplɪʃt
accorded	əˈkɔrdɪd
accosted	əˈkɑstəd
accounted	əˈkaʊntəd
accredited	əˈkrɛdɪtɪd
accrued	əˈkrud
accumulated	əˈkjumjəˌleɪtɪd
accused	əˈkjuzd
accustomed	əˈkʌstəmd
ached	eɪkt
achieved	əˈʧivd
acknowledged	ækˈnɑlɪʤd
acquainted	əˈkweɪntɪd
acquiesced	ˌækwiˈɛst
acquired	əˈkwaɪərd
acquitted	əˈkwɪtəd
acted	ˈæktəd
activated	ˈæktəˌveɪtəd
adapted	əˈdæptəd
added	ˈædəd
addicted	əˈdɪktəd
addressed	əˈdrɛst
adhered	ædˈhɪrd
adjoined	əˈʤɔɪnd
adjourned	əˈʤɜrnd
adjudged	əˈʤʌʤd
adjusted	əˈʤʌstəd
administered	ədˈmɪnəstərd
admired	ədˈmaɪərd
admitted	ədˈmɪtəd
admonished	ədˈmɑnɪʃt
adopted	əˈdɑptəd
adored	əˈdɔrd
adorned	əˈdɔrnd
adulterated	əˈdʌltəˌreɪtɪd
advanced	ədˈvænst
advertised	ˈædvərˌtaɪzd
advised	ædˈvaɪzd
advocated	ˈædvəˌkeɪtəd
aerated	ˈɛˌreɪtɪd
aerosolized	ˈɛrəˌsɑlaɪzd
affected	əˈfɛktəd
affianced	əˈfaɪənst
affiliated	əˈfɪliˌeɪtəd
affirmed	əˈfɜrmd
affixed	əˈfɪkst
afflicted	əˈflɪktəd
afforded	əˈfɔrdəd
affronted	əˈfrʌntɪd
aged	eɪʤd
aggravated	ˈægrəˌveɪtəd
aggrieved	əˈgrivd
agitated	ˈæʤəˌteɪtəd
agonized	ˈægəˌnaɪzd
agreed	əˈgrid
aided	ˈeɪdəd
aimed	eɪmd
aired	ɛrd
alarmed	əˈlɑrmd
alerted	əˈlɜrtɪd
alienated	ˈeɪliəˌneɪtəd
aligned	əˈlaɪnd
alleged	əˈlɛʤd
allied	əˈlaɪd
alligatored	ˈæləˌgeɪtərd
allocated	ˈæləˌkeɪtɪd
alloted	əˈlɑtɪd
allotted	əˈlɑtɪd
allowed	əˈlaʊd
alluded	əˈludəd
alphabetized	ˈælfəbəˌtaɪzd
altered	ˈɔltərd
alternated	ˈɔltərˌneɪtəd
amalgamated	əˈmælgəˌmeɪtɪd
amazed	əˈmeɪzd
ambled	ˈæmbəld
ambushed	ˈæmˌbʊʃt
amended	əˈmɛndəd
amounted	əˈmaʊntɪd
amplified	ˈæmpləˌfaɪd
amputated	ˈæmpjəˌteɪtɪd
amused	əmˈjuzd
analysed	ˈænəˌlaɪzd
analyzed	ˈænəˌlaɪzd
anchored	ˈæŋkərd
anesthetized	əˈnɛsθəˌtaɪzd
angered	ˈæŋgərd
anguished	ˈæŋgwɪʃt
animated	ˈænəˌmeɪtəd
announced	əˈnaʊnst
annoyed	əˈnɔɪd
answered	ˈænsərd
anticipated	ænˈtɪsəˌpeɪtəd
antiquated	ˈæntəˌkweɪtəd
apologized	əˈpɑləˌʤaɪzd
appalled	əˈpɔld
appareled	əˈpærəld
appealed	əˈpild
appeared	əˈpɪrd
appeased	əˈpizd
appended	əˈpɛndɪd
applauded	əˈplɔdəd
applied	əˈplaɪd
appointed	əˈpɔɪntəd
apportioned	əˈpɔrʃənd
appraised	əˈpreɪzd
appreciated	əˈpriʃiˌeɪtɪd
apprehended	ˌæprɪˈhɛndəd
apprenticed	əˈprɛntəst
approached	əˈproʊʧt
appropriated	əˈproʊpriˌeɪtɪd
approved	əˈpruvd
approximated	əˈprɑksəˌmeɪtəd
arbitrated	ˈɑrbəˌtreɪtɪd
arched	ɑrʧt
argued	ˈɑrgjud
arisen	əˈrɪzən
armed	ɑrmd
armored	ˈɑrmərd
arose	əˈroʊz
aroused	əˈraʊzd
arraigned	əˈreɪnd
arranged	əˈreɪnʤd
arrested	əˈrɛstəd
arrived	əˈraɪvd
arrowed	ˈæroʊd
articulated	ɑrˈtɪkjəˌleɪtəd
ascended	əˈsɛndəd
ascertained	ˌæsərˈteɪnd
ascribed	əˈskraɪbd
ashamed	əˈʃeɪmd
asked	æskt
aspired	əˈspaɪrd
assailed	əˈseɪld
assassinated	əˈsæsəˌneɪtəd
assaulted	əˈsɔltɪd
assayed	ˈæsid
assembled	əˈsɛmbəld
assented	əˈsɛntɪd
asserted	əˈsɜrtəd
assessed	əˈsɛst
assigned	əˈsaɪnd
assimilated	əˈsɪməˌleɪtɪd
assisted	əˈsɪstəd
associated	əˈsoʊsiˌeɪtəd
assorted	əˈsɔrtɪd
assuaged	əˈsweɪʤd
assumed	əˈsumd
assured	əˈʃʊrd
astonished	əˈstɑnɪʃt
astounded	əˈstaʊndɪd
ate	eɪt
atrophied	ˈætrəfid
attached	əˈtæʧt
attacked	əˈtækt
attained	əˈteɪnd
attempted	əˈtɛmptəd
attended	əˈtɛndəd
attested	əˈtɛstɪd
attired	əˈtaɪrd
attracted	əˈtræktəd
attributed	əˈtrɪbjətəd
attuned	əˈtund
audited	ˈɔdɪtɪd
augmented	ɑgˈmɛntəd
authenticated	ɔˈθɛntəˌkeɪtəd
authorized	ˈɔθəˌraɪzd
automated	ˈɔtəˌmeɪtɪd
availed	əˈveɪld
averaged	ˈævrəʤd
averted	əˈvɜrtəd
avoided	əˈvɔɪdəd
avowed	əˈvaʊd
awaited	əˈweɪtəd
awakened	əˈweɪkənd
awarded	əˈwɔrdəd
awed	ɔd
awoke	əˈwoʊk
babbled	ˈbæbəld
backed	bækt
baffled	ˈbæfəld
bagged	bægd
baited	ˈbeɪtɪd
baked	beɪkt
balanced	ˈbælənst
balked	bɔkt
bandaged	ˈbændəʤd
banded	ˈbændɪd
banged	bæŋd
banished	ˈbænɪʃt
banked	bæŋkt
banned	bænd
bantered	ˈbæntərd
baptized	bæpˈtaɪzd
barbecued	ˈbɑrbɪˌkjud
barbed	bɑrbd
barred	bɑrd
based	beɪst
basked	bæskt
bathed	beɪðd
batted	ˈbætɪd
battered	ˈbætərd
bawled	bɔld
bayed	beɪd
beaded	ˈbidɪd
bearded	ˈbɪrdəd
became	bɪˈkeɪm
beckoned	ˈbɛkənd
become	bɪˈkʌm
bedazzled	bɪˈdæzəld
bedded	ˈbɛdɪd
beefed	bift
befell	bɪˈfɛl
befogged	bɪˈfɑgd
befouled	bɪˈfaʊld
befuddled	bɪˈfʌdəld
began	bɪˈgæn
begged	bɛgd
beguiled	bɪˈgaɪld
begun	bɪˈgʌn
behaved	bɪˈheɪvd
beheld	bɪˈhɛld
belated	bɪˈleɪtɪd
belched	bɛlʧt
believed	bɪˈlivd
bellowed	ˈbɛloʊd
belonged	bɪˈlɔŋd
beloved	bɪˈlʌvd
belted	ˈbɛltəd
benched	bɛnʧt
bended	ˈbɛndɪd
benefited	ˈbɛnəˌfɪtɪd
bent	bɛnt
bequeathed	bəˈkwiθt
berated	bɪˈreɪtɪd
besieged	bɪˈsiʤd
besmirched	bɪˈsmɜrʧt
bested	ˈbɛstɪd
bestowed	bɪˈstoʊd
betrayed	bɪˈtreɪd
betrothed	bɪˈtroʊðd
beveled	ˈbɛvəld
bewildered	bɪˈwɪldərd
bewitched	bɪˈwɪʧt
bigoted	ˈbɪgətɪd
billed	bɪld
billowed	ˈbɪloʊd
birthed	bɜrθt
bit	bɪt
bitten	ˈbɪtən
blabbed	blæbd
blacked	blækt
blackened	ˈblækənd
blamed	bleɪmd
blanketed	ˈblæŋkətɪd
blared	blɛrd
blasphemed	blæsˈfimd
blasted	ˈblæstəd
blazed	bleɪzd
bleached	bliʧt
bled	blɛd
blended	ˈblɛndəd
blessed	blɛst
blew	blu
blighted	ˈblaɪtɪd
blinded	ˈblaɪndɪd
blinked	blɪŋkt
blistered	ˈblɪstərd
bloated	ˈbloʊtɪd
blocked	blɑkt
blooded	ˈblʌdɪd
bloomed	blumd
blossomed	ˈblɑsəmd
blotted	ˈblɑtəd
blundered	ˈblʌndərd
blunted	ˈblʌntəd
blurred	blɜrd
blurted	ˈblɜrtɪd
blushed	blʌʃt
blustered	ˈblʌstərd
boarded	ˈbɔrdəd
boasted	ˈboʊstəd
bobbed	bɑbd
bogged	bɑgd
boggled	ˈbɑgəld
boiled	bɔɪld
bolstered	ˈboʊlstərd
bolted	ˈboʊltəd
bombed	bɑmd
bonded	ˈbɑndəd
booked	bʊkt
boomed	bumd
boosted	ˈbustɪd
booted	ˈbutɪd
bordered	ˈbɔrdərd
bore	bɔr
bored	bɔrd
borne	bɔrn
borrowed	ˈbɑˌroʊd
bossed	bɑst
bothered	ˈbɑðərd
bottled	ˈbɑtəld
bought	bɑt
bounced	baʊnst
bound	baʊnd
bounded	ˈbaʊndəd
bowed	baʊd
boxed	bɑkst
boycotted	ˈbɔɪˌkɑtɪd
braced	breɪst
bragged	brægd
braided	ˈbreɪdɪd
branched	brænʧt
branded	ˈbrændɪd
braved	breɪvd
breakfasted	ˈbrɛkfəstɪd
breasted	ˈbrɛstəd
breathed	briðd
bred	brɛd
brewed	brud
bribed	braɪbd
briefed	brift
brightened	ˈbraɪtənd
brimmed	brɪmd
bristled	ˈbrɪsəld
broached	broʊʧt
broadened	ˈbrɔdənd
broiled	brɔɪld
broke	broʊk
broken	ˈbroʊkən
bronzed	brɑnzd
brooked	brʊkt
brought	brɔt
bruised	bruzd
brushed	brʌʃt
brutalized	ˈbrutəˌlaɪzd
bubbled	ˈbʌbəld
bucked	bʌkt
buckled	ˈbʌkəld
budded	ˈbʌdɪd
budgeted	ˈbʌʤɪtəd
buffered	ˈbʌfərd
buffeted	bəˈfeɪd
bugged	bʌgd
built	bɪlt
bulged	bʌlʤd
bulked	bʌlkt
bumped	bʌmpt
bunched	bʌnʧt
bundled	ˈbʌndəld
bungled	ˈbʌŋgəld
bunkered	ˈbʌŋkərd
buoyed	ˈbuid
burdened	ˈbɜrdənd
burgeoned	ˈbɜrʤənd
buried	ˈbɛrid
burned	bɜrnd
burnished	ˈbɜrnɪʃt
burnt	bɜrnt
burrowed	ˈbɜroʊd
busied	ˈbɪzid
busted	ˈbʌstɪd
butchered	ˈbʊʧərd
butted	ˈbjutɪd
buttoned	ˈbʌtənd
buttressed	ˈbʌtrəst
buzzed	bʌzd
cabled	ˈkeɪbəld
cackled	ˈkækəld
caged	keɪʤd
caked	keɪkt
calcified	ˈkælsəˌfaɪd
calculated	ˈkælkjəˌleɪtəd
calibrated	ˈkæləˌbreɪtəd
called	kɔld
calloused	ˈkæləst
calmed	kɑmd
came	keɪm
camouflaged	ˈkæməˌflɑʒd
campaigned	kæmˈpeɪnd
camped	kæmpt
cancelled	ˈkænsəld
candied	ˈkændid
canned	kænd
canonized	ˈkænəˌnaɪzd
cantered	ˈkæntərd
canvassed	ˈkænvəst
capitulated	kəˈpɪʧəˌleɪtɪd
capped	kæpt
captivated	ˈkæptɪˌveɪtɪd
captured	ˈkæpʧərd
cared	kɛrd
careened	kəˈrind
caressed	kəˈrɛst
caricatured	kəˈrɪkəʧərd
carpeted	ˈkɑrpətɪd
carried	ˈkærid
carted	ˈkɑrtɪd
carved	kɑrvd
cascaded	kæˈskeɪdɪd
cased	keɪst
cashed	kæʃt
cassocked	ˈkæsəkt
castigated	ˈkæstəˌgeɪtɪd
catapulted	ˈkætəˌpʌltɪd
categorized	ˈkætəgəˌraɪzd
catered	ˈkeɪtərd
caught	kɑt
caused	kɑzd
cautioned	ˈkɑʃənd
caved	keɪvd
ceased	sist
celebrated	ˈsɛləˌbreɪtəd
cemented	səˈmɛntəd
censored	ˈsɛnsərd
censured	ˈsɛnʃərd
centered	ˈsɛntərd
centralized	ˈsɛntrəˌlaɪzd
centrifuged	ˈsɛntrəˌfjuʤd
cerebrated	ˈsɛrəˌbreɪtɪd
certified	ˈsɜrtəˌfaɪd
chalked	ʧɔkt
challenged	ˈʧælənʤd
chambered	ˈʧeɪmbərd
chanced	ʧænst
changed	ʧeɪnʤd
channeled	ˈʧænəld
chanted	ˈʧæntɪd
chaperoned	ˈʃæpəˌroʊnd
chapped	ʧæpt
characterized	ˈkɛrəktəˌraɪzd
charged	ʧɑrʤd
charmed	ʧɑrmd
charred	ʧɑrd
charted	ˈʧɑrtəd
chartered	ˈʧɑrtərd
chased	ʧeɪst
chatted	ˈʧætəd
chattered	ˈʧætərd
chauffeured	ʃoʊˈfɜrd
cheated	ˈʧitəd
checked	ʧɛkt
cheered	ʧɪrd
cherished	ˈʧɛrɪʃt
chewed	ʧud
chided	ˈʧaɪdɪd
chilled	ʧɪld
chinked	ʧɪŋkt
chipped	ʧɪpt
chirped	ʧɜrpt
chiseled	ˈʧɪzəld
choked	ʧoʊkt
chopped	ʧɑpt
choreographed	ˈkɔriəˌgræft
chortled	ˈʧɔrtəld
chorused	ˈkɔrəst
chose	ʧoʊz
chosen	ˈʧoʊzən
christened	ˈkrɪsənd
chromed	kroʊmd
chronicled	ˈkrɑnɪkəld
chuckled	ˈʧʌkəld
churned	ʧɜrnd
circled	ˈsɜrkəld
circulated	ˈsɜrkjəˌleɪtəd
circumscribed	ˌsɜrkəmˈskraɪbd
cited	ˈsaɪtəd
civilized	ˈsɪvəˌlaɪzd
claimed	kleɪmd
clambered	ˈklæmbərd
clamored	ˈklæmərd
clamped	klæmpt
clanged	klæŋd
clapped	klæpt
clarified	ˈklɛrəˌfaɪd
clashed	klæʃt
clasped	klæspt
classed	klæst
classified	ˈklæsəˌfaɪd
clattered	ˈklætərd
clawed	klɔd
cleaned	klind
cleansed	klɛnzd
cleared	klɪrd
cleaved	klivd
clenched	klɛnʧt
clicked	klɪkt
climaxed	ˈklaɪˌmækst
climbed	klaɪmd
clinched	klɪnʧt
clinked	klɪŋkt
clipped	klɪpt
clobbered	ˈklɑbərd
clocked	klɑkt
clogged	klɔgd
closed	kloʊzd
closeted	ˈklɑzətɪd
clothed	kloʊðd
clotted	ˈklɑtəd
clouded	ˈklaʊdɪd
clubbed	klʌbd
clucked	klʌkt
clung	klʌŋ
clustered	ˈklʌstərd
clutched	klʌʧt
cluttered	ˈklʌtərd
coalesced	ˌkoʊəˈlɛst
coarsened	ˈkɔrsənd
coasted	ˈkoʊstɪd
coated	ˈkoʊtəd
coaxed	koʊkst
cocked	kɑkt
coddled	ˈkɑdəld
coded	ˈkoʊdɪd
codified	ˈkɑdəˌfaɪd
coerced	koʊˈɜrst
coiled	kɔɪld
coincided	ˌkoʊənˈsaɪdəd
coined	kɔɪnd
collaborated	kəˈlæbəˌreɪtəd
collapsed	kəˈlæpst
collared	ˈkɑlərd
collated	kəˈleɪtɪd
collected	kəˈlɛktəd
collided	kəˈlaɪdɪd
colonized	ˈkɑləˌnaɪzd
colored	ˈkʌlərd
combatted	ˈkɑmbætɪd
combed	koʊmd
combined	kəmˈbaɪnd
come	kʌm
comforted	ˈkʌmfərtɪd
commanded	kəˈmændəd
commandeered	ˌkɑmənˈdɪrd
commemorated	kəˈmɛməˌreɪtɪd
commenced	kəˈmɛnst
commended	kəˈmɛndɪd
commented	ˈkɑmɛntəd
commingled	kɑˈmɪŋgəld
commissioned	kəˈmɪʃənd
committed	kəˈmɪtəd
communicated	kəmˈjunəˌkeɪtɪd
commuted	kəmˈjutɪd
compared	kəmˈpɛrd
compelled	kəmˈpɛld
compensated	ˈkɑmpənˌseɪtəd
competed	kəmˈpitɪd
compiled	kəmˈpaɪld
complained	kəmˈpleɪnd
completed	kəmˈplitəd
complicated	ˈkɑmpləˌkeɪtəd
complied	kəmˈplaɪd
complimented	ˈkɑmpləˌmɛntɪd
comported	kəmˈpɔrtəd
composed	kəmˈpoʊzd
compounded	kəmˈpaʊndəd
comprehended	ˌkɑmprɪˈhɛndɪd
compressed	kəmˈprɛst
comprised	kəmˈpraɪzd
compromised	ˈkɑmprəˌmaɪzd
computed	kəmˈpjutəd
concealed	kənˈsild
conceded	kənˈsidɪd
conceived	kənˈsivd
concentrated	ˈkɑnsənˌtreɪtəd
concerned	kənˈsɜrnd
concerted	kənˈsɜrtəd
concluded	kənˈkludəd
concocted	kənˈkɑktəd
concurred	kənˈkɜrd
condemned	kənˈdɛmd
condensed	kənˈdɛnst
conditioned	kənˈdɪʃənd
condoned	kənˈdoʊnd
conducted	kənˈdʌktəd
confabulated	kənˈfæbjəˌleɪtɪd
conferred	kənˈfɜrd
confessed	kənˈfɛst
confided	kənˈfaɪdəd
confined	kənˈfaɪnd
confirmed	kənˈfɜrmd
confiscated	ˈkɑnfəˌskeɪtəd
conformed	kənˈfɔrmd
confounded	kənˈfaʊndɪd
confronted	kənˈfrʌntəd
confused	kənˈfjuzd
congealed	kənˈʤild
congested	kənˈʤɛstəd
congratulated	kənˈgræʧəˌleɪtɪd
congregated	ˈkɑŋgrɪˌgeɪtɪd
conjectured	kənˈʤɛkʧərd
conjoined	ˌkɑnˈʤɔɪnd
conjugated	ˌkɑnʤəˈgeɪtɪd
conjured	ˈkɑnʤərd
connected	kəˈnɛktəd
conned	kɑnd
conquered	ˈkɑŋkərd
conscripted	kənˈskrɪptɪd
consented	kənˈsɛntɪd
considered	kənˈsɪdərd
consigned	kənˈsaɪnd
consisted	kənˈsɪstəd
consoled	kənˈsoʊld
consolidated	kənˈsɑləˌdeɪtəd
consorted	kənˈsɔrtɪd
conspired	kənˈspaɪərd
constituted	ˈkɑnstəˌtutəd
constrained	kənˈstreɪnd
constricted	kənˈstrɪktəd
constructed	kənˈstrʌktəd
construed	kənˈstrud
consulted	kənˈsʌltəd
consumed	kənˈsumd
consummated	ˈkɑnsəˌmeɪtəd
contacted	ˈkɑnˌtæktɪd
contained	kənˈteɪnd
contaminated	kənˈtæməˌneɪtəd
contemplated	ˈkɑntəmˌpleɪtɪd
contended	kənˈtɛndɪd
contented	kənˈtɛntəd
contested	kənˈtɛstəd
continued	kənˈtɪnjud
contorted	kənˈtɔrtəd
contracted	ˈkɑntræktəd
contradicted	ˌkɑntrəˈdɪktəd
contrasted	kənˈtræstəd
contributed	kənˈtrɪbjutɪd
contrived	kənˈtraɪvd
controlled	kənˈtroʊld
convened	kənˈvind
conventionalized	kənˈvɛnʧənəˌlaɪzd
converged	kənˈvɜrʤd
converted	kənˈvɜrtɪd
conveyed	kənˈveɪd
convicted	kənˈvɪktəd
convinced	kənˈvɪnst
convoluted	ˈkɑnvəˌlutəd
convulsed	kənˈvʌlst
cooked	kʊkt
cooled	kuld
cooped	kupt
cooperated	koʊˈɑpəˌreɪtəd
coordinated	koʊˈɔrdəneɪtɪd
copied	ˈkɑpid
corded	ˈkɔrdəd
corked	kɔrkt
cornered	ˈkɔrnərd
corrected	kəˈrɛktəd
correlated	ˈkɔrəˌleɪtəd
corresponded	ˌkɔrəˈspɑndɪd
corroborated	kəˈrɑbəˌreɪtɪd
corrugated	ˈkɔrəˌgeɪtəd
corrupted	kəˈrʌptɪd
costumed	ˈkɔˌstumd
couched	kaʊʧt
coughed	kɔft
counseled	ˈkaʊnsəld
counted	ˈkaʊntəd
counteracted	ˈkaʊntəˌræktɪd
counterbalanced	ˌkaʊntərˈbælənst
countered	ˈkaʊntərd
coupled	ˈkʌpəld
courted	ˈkɔrtɪd
covered	ˈkʌvərd
coveted	ˈkʌvətɪd
crabbed	kræbd
cracked	krækt
crackled	ˈkrækəld
cradled	ˈkreɪdəld
crammed	kræmd
crashed	kræʃt
craved	kreɪvd
crawled	krɔld
crazed	kreɪzd
creaked	krikt
creamed	krimd
creased	krist
created	kriˈeɪtəd
credited	ˈkrɛdətəd
cremated	ˈkrimeɪtɪd
crept	krɛpt
crested	ˈkrɛstəd
cried	kraɪd
cringed	krɪnʤd
crippled	ˈkrɪpəld
crisscrossed	ˈkrɪˌskrɔst
criticized	ˈkrɪtəˌsaɪzd
croaked	kroʊkt
crocked	krɑkt
crooked	krʊkt
crooned	krund
cropped	krɑpt
crossed	krɔst
crouched	kraʊʧt
crowded	ˈkraʊdəd
crowed	kroʊd
crowned	kraʊnd
crucified	ˈkrusəˌfaɪd
crumbled	ˈkrʌmbəld
crumpled	ˈkrʌmpəld
crunched	krʌnʧt
crushed	krʌʃt
crystallized	ˈkrɪstəˌlaɪzd
cubed	kjubd
culminated	ˈkʌlməˌneɪtəd
cultivated	ˈkʌltəˌveɪtɪd
cultured	ˈkʌlʧərd
cupped	kʌpt
cured	kjʊrd
curled	kɜrld
cursed	kɜrst
curtailed	kərˈteɪld
curtained	ˈkɜrtənd
curved	kɜrvd
cycled	ˈsaɪkəld
dabbed	dæbd
dabbled	ˈdæbəld
damaged	ˈdæməʤd
dammed	dæmd
damned	dæmd
dampened	ˈdæmpənd
danced	dænst
dangled	ˈdæŋgəld
dappled	ˈdæpəld
dared	dɛrd
darkened	ˈdɑrkənd
darned	dɑrnd
darted	ˈdɑrtɪd
dashed	dæʃt
dated	ˈdeɪtɪd
daubed	dɔbd
daunted	ˈdɔntɪd
dazed	deɪzd
dazzled	ˈdæzəld
deactivated	ˌdiˈæktɪˌveɪtɪd
deadened	ˈdɛdənd
deafened	ˈdɛfənd
dealt	dɛlt
debated	dəˈbeɪtɪd
debilitated	dəˈbɪləˌteɪtɪd
decanted	dəˈkæntɪd
decayed	dəˈkeɪd
deceased	dɪˈsist
deceived	dɪˈsivd
decided	ˌdɪˈsaɪdɪd
decked	dɛkt
declaimed	dɪˈkleɪmd
declared	dɪˈklɛrd
declined	dɪˈklaɪnd
decorated	ˈdɛkəˌreɪtəd
decreased	dɪˈkrist
decreed	dɪˈkrid
dedicated	ˈdɛdəkeɪtəd
deduced	dɪˈdust
deducted	dɪˈdʌktɪd
deemed	dimd
deepened	ˈdipənd
defaulted	dɪˈfɔltɪd
defeated	dɪˈfitəd
defecated	ˈdɛfəˌkeɪtəd
defended	dɪˈfɛndəd
deferred	dɪˈfɜrd
defied	dɪˈfaɪd
defined	dɪˈfaɪnd
deflated	dɪˈfleɪtɪd
degenerated	dɪˈʤɛnəˌreɪtɪd
degraded	dɪˈgreɪdəd
dehumidified	dihjuˈmɪdəfaɪd
dehydrated	dɪˈhaɪdreɪtəd
deigned	deɪnd
dejected	dɪˈʤɛktɪd
delayed	dɪˈleɪd
delegated	ˈdɛləˌgeɪtəd
delighted	dɪˈlaɪtəd
delineated	dɪˈlɪniˌeɪtɪd
delivered	dɪˈlɪvərd
deloused	ˌdiˈlaʊzd
deluded	dɪˈludɪd
deluged	ˈdɛljuʤd
demanded	dɪˈmændəd
demarcated	ˈdimɑrˌkeɪtəd
demented	dɪˈmɛntɪd
demolished	dɪˈmɑlɪʃt
demonstrated	ˈdɛmənˌstreɪtəd
demoralized	dɪˈmɔrəˌlaɪzd
demoted	dɪˈmoʊtɪd
demythologized	ˌdiməˈθɑlədʒaɪzd
denatured	dɪˈneɪʧərd
denied	dɪˈnaɪd
denominated	dɪˈnɑməˌneɪtɪd
denoted	dɪˈnoʊtəd
denounced	dɪˈnaʊnst
dented	ˈdɛntɪd
departed	dɪˈpɑrtəd
depended	dɪˈpɛndəd
depersonalized	diˈpɜrsənəˌlaɪzd
depicted	dɪˈpɪktəd
deplored	dɪˈplɔrd
deployed	dɪˈplɔɪd
deposited	dəˈpɑzɪtɪd
depraved	diˈpreɪvd
depressed	dɪˈprɛst
deprived	dɪˈpraɪvd
deputized	ˈdɛpjəˌtaɪzd
deranged	dɪˈreɪnʤd
derived	dəˈraɪvd
descended	dɪˈsɛndəd
described	dɪˈskraɪbd
desecrated	dɛzəˈkreɪtɪd
desegregated	dɪˈsɛgrɪˌgeɪtɪd
desensitized	dɪˈsɛnsəˌtaɪzd
deserted	dɪˈzɜrtɪd
deserved	dɪˈzɜrvd
designated	ˈdɛzɪgˌneɪtɪd
designed	dɪˈzaɪnd
desired	dɪˈzaɪərd
despised	dɪˈspaɪzd
despoiled	dɪˈspɔɪld
destined	ˈdɛstɪnd
destroyed	dɪˈstrɔɪd
detached	dɪˈtæʧt
detailed	dɪˈteɪld
detained	dɪˈteɪnd
detected	dɪˈtɛktəd
deteriorated	dɪˈtɪriəˌreɪtɪd
determined	dɪˈtɜrmənd
detested	dɪˈtɛstɪd
detonated	ˈdɛtəˌneɪtəd
detoured	ˈditʊrd
devastated	ˈdɛvəˌsteɪtəd
developed	dɪˈvɛləpt
deviated	ˈdiviˌeɪtɪd
devised	dɪˈvaɪzd
devoted	dɪˈvoʊtəd
devoured	dɪˈvaʊərd
diagnosed	ˌdaɪəgˈnoʊst
diagrammed	ˈdaɪəˌgræmd
dialed	ˈdaɪəld
dictated	dɪkˈteɪtəd
died	daɪd
differed	ˈdɪfərd
differentiated	ˌdɪfəˈrɛnʃiˌeɪtɪd
diffused	dɪˈfjuzd
digested	ˈdaɪˌʤɛstɪd
dignified	ˈdɪgnəˌfaɪd
dilapidated	dəˈlæpəˌdeɪtɪd
dilated	daɪˈleɪtəd
diluted	daɪˈlutəd
diminished	dɪˈmɪnɪʃt
dined	daɪnd
dipped	dɪpt
directed	dəˈrɛktəd
disabled	dɪˈseɪbəld
disaffected	ˌdɪsəˈfɛktɪd
disaffiliated	ˌdɪsəˈfɪliˌeɪtəd
disagreed	dɪsəˈgrid
disallowed	ˌdɪsəˈlaʊd
disappeared	ˌdɪsəˈpɪrd
disappointed	ˌdɪsəˈpɔɪntɪd
disapproved	ˌdɪsəˈpruvd
disarmed	dɪˈsɑrmd
disarranged	ˌdɪsəˈreɪnʤd
disbanded	dɪsˈbændɪd
disbelieved	dɪsbəˈlivd
disbursed	dɪsˈbɜrst
discarded	dɪˈskɑrdɪd
discerned	dɪˈsɜrnd
discharged	dɪsˈʧɑrʤd
disciplined	ˈdɪsəplənd
disclaimed	dɪˈskleɪmd
disclosed	dɪˈskloʊzd
discolored	dɪˈskʌlərd
disconnected	ˌdɪskəˈnɛktɪd
discontented	ˌdɪskənˈtɛntɪd
discontinued	dɪskənˈtɪnjud
discounted	ˈdɪˌskaʊntɪd
discouraged	dɪˈskərəʤd
discovered	dɪˈskʌvərd
discredited	dɪˈskrɛdɪtɪd
discussed	dɪˈskʌst
diseased	dɪˈzizd
disembodied	dɪsɪˈbɑdid
disenfranchised	dɪsɪnˈfrænˌʧaɪzd
disfigured	dɪˈsfɪgjərd
disgraced	dɪsˈgreɪst
disgruntled	dɪsˈgrʌntəld
disguised	dɪsˈgaɪzd
disgusted	dɪsˈgʌstəd
disheartened	dɪsˈhɑrtənd
dished	dɪʃt
disheveled	dɪˈʃɛvəld
dishevelled	dɪˈʃɛvəld
dishonored	dɪˈsɑnərd
disillusioned	ˌdɪsɪˈluʒənd
disinterested	dɪˈsɪntrɪstɪd
disjointed	dɪsˈʤɔɪntɪd
disliked	dɪˈslaɪkt
dislocated	ˈdɪsloʊkeɪtɪd
dislodged	dɪˈslɑʤd
dismayed	dɪˈsmeɪd
dismembered	dɪˈsmɛmbərd
dismissed	dɪˈsmɪst
dismounted	dɪˈsmaʊntəd
disobeyed	ˌdɪsoʊˈbeɪd
disordered	dɪˈsɔrdərd
disorganized	dɪˈsɔrgəˌnaɪzd
disoriented	dɪˈsɔriˌɛntɪd
disowned	dɪˈsoʊnd
dispatched	dɪˈspæʧt
dispelled	dɪˈspɛld
dispensed	dɪˈspɛnst
dispersed	dɪˈspɜrst
displaced	dɪˈspleɪst
displayed	dɪˈspleɪd
displeased	dɪˈsplizd
disposed	dɪˈspoʊzd
dispossessed	ˌdɪspəˈzɛst
disputed	dɪˈspjutəd
disqualified	dɪˈskwɑləˌfaɪd
disregarded	ˌdɪsrɪˈgɑrdɪd
disrupted	dɪsˈrʌptɪd
dissatisfied	dɪˈsætəˌsfaɪd
disseminated	dɪˈsɛməˌneɪtəd
dissented	dɪˈsɛntɪd
dissipated	ˈdɪsəˌpeɪtɪd
dissociated	dɪˈsoʊsieɪtɪd
dissolved	dɪˈzɑlvd
distilled	dɪˈstɪld
distinguished	dɪˈstɪŋgwɪʃt
distorted	dɪˈstɔrtəd
distracted	dɪˈstræktəd
distressed	dɪˈstrɛst
distributed	dɪˈstrɪbjətəd
distrusted	dɪˈstrʌstəd
disturbed	dɪˈstɜrbd
disunited	ˌdɪsjəˈnaɪtəd
dived	daɪvd
diversified	daɪˈvɜrsəˌfaɪd
diverted	daɪˈvɜrtɪd
divided	dɪˈvaɪdəd
divorced	dɪˈvɔrst
docked	dɑkt
docketed	ˈdɑkətɪd
doctored	ˈdɑktərd
documented	ˈdɑkjəˌmɛntəd
dodged	dɑʤd
dogged	dɔgd
doled	doʊld
domed	doʊmd
domiciled	ˈdɑmɪˌsaɪld
dominated	ˈdɑməˌneɪtəd
donated	ˈdoʊˌneɪtəd
donned	dɑnd
doomed	dumd
doped	doʊpt
dosed	doʊst
dotted	ˈdɑtəd
doubled	ˈdʌbəld
doubted	ˈdaʊtɪd
doused	daʊst
dove	dʌv
downed	daʊnd
dozed	doʊzd
drafted	ˈdræftɪd
dragged	drægd
drained	dreɪnd
drank	dræŋk
draped	dreɪpt
drawled	drɔld
dreaded	ˈdrɛdɪd
dreamed	drimd
dreamt	drɛmt
drenched	drɛnʧt
dressed	drɛst
drew	dru
dribbled	ˈdrɪbəld
dried	draɪd
drifted	ˈdrɪftəd
drilled	drɪld
dripped	drɪpt
driven	ˈdrɪvən
drooped	drupt
dropped	drɑpt
drove	droʊv
drowned	draʊnd
drowsed	draʊzd
drugged	drʌgd
drummed	drʌmd
drunk	drʌŋk
dubbed	dʌbd
ducked	dʌkt
dug	dʌg
dulled	dʌld
dumped	dʌmpt
duped	dupt
duplicated	ˈduplɪˌkeɪtɪd
dusted	ˈdʌstɪd
dwarfed	dwɔrft
dwelt	dwɛlt
dwindled	ˈdwɪndəld
dyed	daɪd
dynamited	ˈdaɪnəˌmaɪtɪd
earned	ɜrnd
eased	izd
eaten	ˈitən
echoed	ˈɛkoʊd
eclipsed	ɪˈklɪpst
edged	ɛʤd
edified	ˈɛdəˌfaɪd
edited	ˈɛdətəd
educated	ˈɛʤəˌkeɪtəd
effected	ɪˈfɛktəd
egged	ɛgd
ejaculated	ɪˈʤækjuˌleɪtɪd
ejected	ɪˈʤɛktɪd
elaborated	ɪˈlæbəreɪtəd
elapsed	ɪˈlæpst
elated	ɪˈleɪtəd
elected	ɪˈlɛktəd
elevated	ˈɛləˌveɪtɪd
elicited	ɪˈlɪsɪtɪd
eliminated	ɪˈlɪməˌneɪtəd
elongated	ɪˈlɔŋgeɪtəd
eloped	ɪˈloʊpt
elucidated	ɪˈlusəˌdeɪtəd
eluded	ɪˈludɪd
emaciated	ɪˈmeɪʃiˌeɪtɪd
emanated	ˈɛməˌneɪtɪd
emancipated	ɪˈmænsəˌpeɪtɪd
emasculated	əˈmæskjuˌleɪtɪd
embarked	ɛmˈbɑrkt
embarrassed	ɪmˈbɛrəst
embattled	ɛmˈbætəld
embedded	ɛmˈbɛdɪd
embellished	ɛmˈbɛlɪʃt
embittered	ɛmˈbɪtərd
embodied	ɪmˈbɑdid
emboldened	ɛmˈboʊldənd
embossed	ɪmˈbɔst
embraced	ɛmˈbreɪst
embroidered	ɛmˈbrɔɪdərd
embroiled	ɛmˈbrɔɪld
emerged	ɪˈmɜrʤd
emigrated	ˈɛməˌgreɪtɪd
emitted	ɪˈmɪtəd
emphasized	ˈɛmfəˌsaɪzd
employed	ɛmˈplɔɪd
empowered	ɪmˈpaʊərd
emptied	ˈɛmptid
emulated	ˈɛmjəˌleɪtɪd
emulsified	ɛˈmulsəˌfaɪd
enabled	ɛˈneɪbəld
enacted	ɛˈnæktəd
enamelled	ɪˈnæməld
encamped	ɪnˈkæmpt
encased	ɛnˈkeɪst
enchained	ɛnˈʧeɪnd
enchanted	ɛnˈʧæntɪd
encircled	ɪnˈsɜrkəld
enclosed	ɛnˈkloʊzd
encompassed	ɛnˈkʌmpəst
encountered	ɪnˈkaʊntərd
encouraged	ɛnˈkɜrɪʤd
encroached	ɪnˈkroʊʧt
encrusted	ɛnˈkrʌstɪd
encumbered	ɛnˈkʌmbərd
endangered	ɛnˈdeɪnʤərd
endeared	ɛnˈdird
endeavored	ɪnˈdɛvərd
ended	ˈɛndəd
endorsed	ɛnˈdɔrst
endowed	ɛnˈdaʊd
endured	ɛnˈdjʊrd
energized	ˈɛnərˌʤaɪzd
enforced	ɛnˈfɔrst
engaged	ɛnˈgeɪʤd
engendered	ɛnˈʤɛndərd
engraved	ɪnˈgreɪvd
engrossed	ɪnˈgroʊst
engulfed	ɪnˈgʌlft
enhanced	ɛnˈhænst
enjoined	ɛnˈʤɔɪnd
enjoyed	ɛnˈʤɔɪd
enlarged	ɛnˈlɑrʤd
enlightened	ɛnˈlaɪtənd
enlisted	ɛnˈlɪstɪd
enlivened	ɛnˈlaɪvənd
enmeshed	ɛnˈmɛʃt
enraged	ɛnˈreɪʤd
enraptured	ɛnˈræpʧərd
enriched	ɛnˈrɪʧt
enrolled	ɛnˈroʊld
ensconced	ɪnˈskɑnst
enslaved	ɛnˈsleɪvd
ensued	ɪnˈsud
entered	ˈɛntərd
entertained	ˌɛntərˈteɪnd
enthralled	ɛnˈθrɔld
entitled	ɛnˈtaɪtəld
entombed	ɛnˈtumd
entranced	ɪnˈtrænst
entreated	ɪnˈtritəd
entrenched	ɛnˈtrɛnʧt
entrusted	ɛnˈtrʌstɪd
entwined	ɛnˈtwaɪnd
enumerated	ɪˈnuməˌreɪtɪd
enunciated	ɪˈnʌnsiˌeɪtɪd
envenomed	ɪnˈvɛnəmd
envied	ˈɛnvid
envisaged	ɛnˈvɪzɪʤd
envisioned	ɛnˈvɪʒənd
epitomized	ɪˈpɪtəˌmaɪzd
equalled	ˈikwəld
equated	ɪˈkweɪtɪd
equipped	ɪˈkwɪpt
erased	ɪˈreɪst
erected	ɪˈrɛktəd
eroded	ɪˈroʊdəd
erred	ɛrd
erupted	ˌɪˈrʌptɪd
escaped	ɪˈskeɪpt
eschewed	ˌɛˈʃud
escorted	ɛˈskɔrtɪd
espoused	ɪˈspaʊzd
essayed	ɛˈseɪd
established	ɪˈstæblɪʃt
esteemed	ɪˈstimd
estimated	ˈɛstəˌmeɪtəd
estranged	ɛˈstreɪnʤd
etched	ɛʧt
eulogized	ˈjuləˌʤaɪzd
europeanized	ˌjʊrəˈpiənaɪzd
evacuated	ɪˈvækjəˌweɪtɪd
evaded	ɪˈveɪdɪd
evaluated	ɪˈvæljuˌeɪtəd
evaporated	ɪˈvæpəˌreɪtəd
evicted	ɪˈvɪktɪd
evidenced	ˈɛvɪdənst
evinced	ɪˈvɪnst
evoked	ɪˈvoʊkt
evolved	ɪˈvɑlvd
exacerbated	ɪgˈzæsərˌbeɪtəd
exacted	ɪgˈzæktɪd
exaggerated	ɪgˈzæʤəˌreɪtəd
exalted	ɪgˈzɔltɪd
examined	ɪgˈzæmənd
exasperated	ɪgˈzæspəˌreɪtɪd
exceeded	ɪkˈsidəd
exchanged	ɪksˈʧeɪnʤd
excised	ˈɛkˌsaɪzd
excited	ɪkˈsaɪtəd
exclaimed	ɪkˈskleɪmd
excluded	ɪkˈskludəd
excommunicated	ˌɛkskəmˈjunəˌkeɪtəd
excused	ɪkˈskjuzd
executed	ˈɛksəˌkjutəd
exemplified	ɪgˈzɛmpləˌfaɪd
exercised	ˈɛksərˌsaɪzd
exerted	ɪgˈzɜrtɪd
exhaled	ɛksˈheɪld
exhausted	ɪgˈzɑstəd
exhibited	ɪgˈzɪbətəd
exhilarated	ɪgˈzɪləˌreɪtɪd
exiled	ˈɛgˌzaɪld
existed	ɪgˈzɪstəd
exonerated	ɪgˈzɑnəˌreɪtɪd
expanded	ɪkˈspændəd
expected	ɪkˈspɛktəd
expelled	ɪkˈspɛld
expended	ɪkˈspɛndɪd
experienced	ɪkˈspɪriənst
experimented	ɪkˈspɛrəməntəd
expired	ɪkˈspaɪrd
explained	ɪkˈspleɪnd
exploded	ɪkˈsploʊdəd
exploited	ˈɛkˌsplɔɪtəd
explored	ɪkˈsplɔrd
exported	ɪkˈspɔrtəd
exposed	ɪkˈspoʊzd
expounded	ɪkˈspaʊndəd
expressed	ɪkˈsprɛst
expropriated	ɛkˈsproʊpriˌeɪtɪd
extended	ɪkˈstɛndəd
extinguished	ɪkˈstɪŋgwɪʃt
extracted	ɛkˈstræktɪd
extrapolated	ɛkˈstræpəˌleɪtɪd
extruded	ɪkˈstrudəd
exuded	ɪgˈzudɪd
eyed	aɪd
fabled	ˈfeɪbəld
fabricated	ˈfæbrɪˌkeɪtəd
facaded	fəˈsɑdɪd
faced	feɪst
facilitated	fəˈsɪləˌteɪtɪd
faded	ˈfeɪdəd
failed	feɪld
fainted	ˈfeɪntɪd
faked	feɪkt
fallen	ˈfɑlən
faltered	ˈfɑltərd
famed	feɪmd
fancied	ˈfænsid
fanned	fænd
farmed	fɑrmd
fascinated	ˈfæsəˌneɪtəd
fashioned	ˈfæʃənd
fastened	ˈfæsənd
fathered	ˈfɑðərd
fatigued	fəˈtigd
faulted	ˈfɔltɪd
favored	ˈfeɪvərd
fawned	fɔnd
feared	fɪrd
feathered	ˈfɛðərd
featured	ˈfiʧərd
fed	fɛd
feigned	feɪnd
fell	fɛl
felled	fɛld
felt	fɛlt
fenced	fɛnst
fermented	fərˈmɛntəd
ferreted	ˈfɛrətəd
ferried	ˈfɛrid
fertilized	ˈfɜrtəˌlaɪzd
fevered	ˈfivərd
fielded	ˈfildɪd
figured	ˈfɪgjərd
filched	fɪlʧt
filed	faɪld
filled	fɪld
filmed	fɪlmd
filtered	ˈfɪltərd
financed	fɪˈnænst
fined	faɪnd
fingered	ˈfɪŋgərd
finished	ˈfɪnɪʃt
finned	fɪnd
fired	ˈfaɪərd
fisted	ˈfɪstɪd
fitted	ˈfɪtəd
fixed	fɪkst
fizzled	ˈfɪzəld
flagellated	ˈflæʤəˌleɪtəd
flailed	fleɪld
flamed	fleɪmd
flanked	flæŋkt
flapped	flæpt
flared	flɛrd
flashed	flæʃt
flattened	ˈflætənd
flattered	ˈflætərd
flaunted	ˈflɔntɪd
flavored	ˈfleɪvərd
flecked	flɛkt
fled	flɛd
flew	flu
flexed	flɛkst
flicked	flɪkt
flickered	ˈflɪkərd
flipped	flɪpt
flirted	ˈflɜrtɪd
floated	ˈfloʊtəd
flocked	flɑkt
flogged	flɑgd
flooded	ˈflʌdəd
flopped	flɑpt
floundered	ˈflaʊndərd
floured	ˈflaʊərd
flourished	ˈflərɪʃt
flouted	ˈflaʊtɪd
flowed	floʊd
flowered	ˈflaʊərd
flung	flʌŋ
flurried	ˈflərid
flushed	flʌʃt
flustered	ˈflʌstərd
fluted	ˈflutɪd
fluttered	ˈflʌtərd
foamed	foʊmd
focused	ˈfoʊkəst
focussed	ˈfoʊkəst
fogged	fɑgd
foiled	fɔɪld
folded	ˈfoʊldəd
followed	ˈfɑloʊd
fooled	fuld
forbade	fərˈbeɪd
forbidden	ˈfɔrbɪdən
forced	fɔrst
foreclosed	fɔrˈkloʊzd
forfeited	ˈfɔrfɪtɪd
forgave	fərˈgeɪv
forged	fɔrʤd
forgiven	fərˈgɪvən
forgone	fɔrˈgɑn
forgot	fərˈgɑt
forgotten	fərˈgɑtən
forked	fɔrkt
formalized	ˈfɔrməˌlaɪzd
formed	fɔrmd
formulated	ˈfɔrmjəˌleɪtəd
forsaken	fɔrˈseɪkən
fortified	ˈfɔrtəˌfaɪd
forwarded	ˈfɔrwərdɪd
fossilized	ˈfɑsəˌlaɪzd
fostered	ˈfɑstərd
fought	fɔt
fouled	faʊld
found	faʊnd
founded	ˈfaʊndəd
fractionated	ˈfrækʃəˌneɪtəd
fractured	ˈfrækʧərd
fragmented	ˈfrægməntɪd
framed	freɪmd
fraternized	ˈfrætərˌnaɪzd
frayed	freɪd
frazzled	ˈfræzəld
freckled	ˈfrɛkəld
freed	frid
frenzied	ˈfrɛnzid
frequented	ˈfrikwəntɪd
frescoed	ˈfrɛskoʊd
freshened	ˈfrɛʃənd
fretted	ˈfrɛtɪd
fried	fraɪd
frightened	ˈfraɪtənd
fringed	frɪnʤd
fronted	ˈfrʌntɪd
frosted	ˈfrɔstəd
frowned	fraʊnd
froze	froʊz
frozen	ˈfroʊzən
frustrated	ˈfrʌˌstreɪtəd
fueled	ˈfjuəld
fulfilled	fʊlˈfɪld
fumbled	ˈfʌmbəld
fumed	fjumd
functioned	ˈfʌŋkʃənd
funneled	ˈfʌnəld
furled	fɜrld
furloughed	ˈfɜrloʊd
furnished	ˈfɜrnɪʃt
furrowed	ˈfɜroʊd
furthered	ˈfɜrðərd
fused	fjuzd
fuzzed	fʌzd
gagged	gægd
gained	geɪnd
galled	geɪld
galloped	ˈgæləpt
gaped	geɪpt
garaged	gəˈrɑʒd
garbed	gɑrbd
garbled	ˈgɑrbəld
gardened	ˈgɑrdənd
garlanded	ˈgɑrləndɪd
garrisoned	ˈgærəsənd
gasped	gæspt
gassed	gæst
gathered	ˈgæðərd
gauged	geɪʤd
gave	geɪv
gazed	geɪzd
geared	gɪrd
generalized	ˈʤɛnərəˌlaɪzd
generated	ˈʤɛnəˌreɪtəd
germanized	ˌʤɛrməˈnaɪzd
gesticulated	ˌʤəsˈtɪkjəleɪtəd
gestured	ˈʤɛsʧərd
ghosted	ˈgoʊstɪd
gifted	ˈgɪftəd
giggled	ˈgɪgəld
gilded	ˈgɪldɪd
given	ˈgɪvən
glanced	glænst
glared	glɛrd
glazed	gleɪzd
gleamed	glimd
gleaned	glind
glided	ˈglaɪdɪd
glimpsed	glɪmpst
glinted	ˈglɪntɪd
glistened	ˈglɪsənd
glittered	ˈglɪtərd
gloated	ˈgloʊtɪd
glorified	ˈglɔrəˌfaɪd
glossed	glɔst
gloved	glʌvd
glowed	gloʊd
glowered	ˈglaʊərd
glued	glud
glutted	ˈglʌtɪd
gnarled	nɑrld
gnawed	nɔd
goaded	ˈgoʊdɪd
gobbled	ˈgɑbəld
gone	gɔn
goofed	guft
gossiped	ˈgɑsəpt
gouged	gaʊʤd
governed	ˈgʌvərnd
gowned	gaʊnd
grabbed	græbd
graced	greɪst
graded	ˈgreɪdəd
graduated	ˈgræʤuˌeɪtɪd
granted	ˈgræntəd
graphed	græft
grappled	ˈgræpəld
grasped	græspt
grassed	græst
grated	ˈgreɪtɪd
gratified	ˈgrætəˌfaɪd
grayed	greɪd
grazed	greɪzd
greased	grist
greeted	ˈgritəd
grew	gru
grilled	grɪld
grimaced	ˈgrɪməst
grimed	graɪmd
grinned	grɪnd
gripped	grɪpt
grizzled	ˈgrɪzəld
groaned	groʊnd
groomed	grumd
grooved	gruvd
groped	groʊpt
ground	graʊnd
grounded	ˈgraʊndɪd
grouped	grupt
growled	graʊld
grumbled	ˈgrʌmbəld
grunted	ˈgrʌntɪd
guaranteed	ˌgɛrənˈtid
guarded	ˈgɑrdəd
guessed	gɛst
guided	ˈgaɪdəd
gulled	gʌld
gulped	gʌlpt
gushed	gʌʃt
gutted	ˈgʌtɪd
guttered	ˈgʌtərd
guzzled	ˈgʌzəld
hacked	hækt
hailed	heɪld
hallowed	ˈhæloʊd
halted	ˈhɔltəd
hammered	ˈhæmərd
hampered	ˈhæmpərd
handed	ˈhændəd
handicapped	ˈhændiˌkæpt
handled	ˈhændəld
hanged	hæŋd
hankered	ˈhæŋkərd
happened	ˈhæpənd
harangued	həˈræŋd
harassed	həˈræst
harbored	ˈhɑrbərd
hardened	ˈhɑrdənd
harmed	hɑrmd
harnessed	ˈhɑrnəst
harried	ˈhɛrid
harrowed	ˈhæroʊd
harshened	ˈhɑrʃənd
harvested	ˈhɑrvəstəd
hastened	ˈheɪsənd
hatched	hæʧt
hated	ˈheɪtəd
hauled	hɔld
haunted	ˈhɔntəd
hawked	hɔkt
headed	ˈhɛdəd
healed	hild
heaped	hipt
heard	hɜrd
heated	ˈhitəd
heaved	hivd
hedged	hɛʤd
heeded	ˈhidəd
hefted	ˈhɛftɪd
heightened	ˈhaɪtənd
held	hɛld
helped	hɛlpt
hemmed	hɛmd
heralded	ˈhɛrəldɪd
herded	ˈhɜrdɪd
hesitated	ˈhɛzɪˌteɪtɪd
hid	hɪd
hidden	ˈhɪdən
hijacked	ˈhaɪˌʤækt
hiked	haɪkt
hindered	ˈhɪndərd
hinged	hɪnʤd
hinted	ˈhɪntəd
hired	ˈhaɪərd
hissed	hɪst
hitched	hɪʧt
hobbled	ˈhɑbəld
hoisted	ˈhɔɪstəd
holed	hoʊld
hollered	ˈhɑlərd
holstered	ˈhoʊlstərd
honored	ˈɑnərd
hooked	hʊkt
hooted	ˈhutɪd
hoped	hoʊpt
hopped	hɑpt
horned	hɔrnd
horrified	ˈhɔrəˌfaɪd
hospitalized	ˈhɑspɪtəˌlaɪzd
housed	haʊzd
hovered	ˈhʌvərd
howled	haʊld
huddled	ˈhʌdəld
hugged	hʌgd
humbled	ˈhʌmbəld
humiliated	hjuˈmɪliˌeɪtɪd
hummed	hʌmd
humped	hʌmpt
hunched	hʌnʧt
hung	hʌŋ
hunted	ˈhʌntəd
hurdled	ˈhɜrdəld
hurled	hɜrld
hurried	ˈhɜrid
hurtled	ˈhɜrtəld
hushed	hʌʃt
hustled	ˈhʌsəld
hydrated	ˈhaɪˌdreɪtəd
hyphenated	ˈhaɪfəˌneɪtɪd
hypnotized	ˈhɪpnəˌtaɪzd
hypothesized	haɪˈpɑθəˌsaɪzd
iced	aɪst
idealized	aɪˈdiəˌlaɪzd
identified	aɪˈdɛntəˌfaɪd
idled	ˈaɪdəld
idolized	ˈaɪdəˌlaɪzd
ignited	ɪgˈnaɪtɪd
ignored	ɪgˈnɔrd
illuminated	ɪˈluməˌneɪtəd
illustrated	ˈɪləˌstreɪtəd
imagined	ɪˈmæʤənd
imbedded	ɪmˈbɛdɪd
imbibed	ɪmˈbaɪbd
imbued	ɪmˈbjud
imitated	ˈɪməˌteɪtɪd
immersed	ɪˈmɜrst
immortalized	ɪˈmɔrtəlaɪzd
impacted	ˈɪmˌpæktɪd
impaired	ɪmˈpɛrd
impaled	ɪmˈpeɪld
imparted	ɪmˈpɑrtɪd
impassioned	ɪmˈpæʃənd
impeded	ɪmˈpidɪd
impelled	ɪmˈpɛld
imperiled	ɪmˈpɛrəld
imperilled	ɪmˈpɛrəld
impersonated	ɪmˈpɜrsəˌneɪtɪd
implanted	ɪmˈplæntɪd
implemented	ˈɪmpləˌmɛntəd
implicated	ˈɪmplɪˌkeɪtɪd
implied	ɪmˈplaɪd
implored	ɪmˈplɔrd
imported	ɪmˈpɔrtɪd
imposed	ɪmˈpoʊzd
impoverished	ɪmˈpɑvrɪʃt
impressed	ɪmˈprɛst
imprinted	ɪmˈprɪntɪd
imprisoned	ɪmˈprɪzənd
improved	ɪmˈpruvd
improvised	ˈɪmprəˌvaɪzd
inaugurated	ɪˈnɔgəˌreɪtɪd
incapacitated	ɪnkəˈpæsɪˌteɪtɪd
incarcerated	ɪnˈkɑrsəˌreɪtɪd
incensed	ˈɪnˌsɛnst
inched	ɪnʧt
incited	ɪnˈsaɪtɪd
inclined	ɪnˈklaɪnd
included	ɪnˈkludəd
incorporated	ɪnˈkɔrpəˌreɪtəd
increased	ɪnˈkrist
incubated	ˈɪnkjəˌbeɪtɪd
incurred	ɪnˈkɜrd
indebted	ɪnˈdɛtəd
indentured	ɪnˈdɛnʧərd
indicated	ˈɪndəˌkeɪtəd
indicted	ɪnˈdaɪtəd
indisposed	ˌɪndɪˈspoʊzd
individualized	ˌɪndɪˈvɪʤuəlaɪzd
indoctrinated	ɪnˈdɑktrəˌneɪtɪd
induced	ɪnˈdust
inducted	ɪnˈdʌktəd
indulged	ɪnˈdʌlʤd
industrialized	ɪnˈdʌstriəˌlaɪzd
inexperienced	ɪnɪkˈspɪriənst
infected	ɪnˈfɛktəd
inferred	ɪnˈfɜrd
infested	ɪnˈfɛstəd
infiltrated	ɪnˈfɪlˌtreɪtɪd
inflamed	ɪnˈfleɪmd
inflated	ɪnˈfleɪtəd
inflected	ɪnˈflɛktəd
inflicted	ɪnˈflɪktɪd
influenced	ˈɪnfluənst
informed	ɪnˈfɔrmd
infuriated	ɪnˈfjʊriˌeɪtəd
ingested	ɪnˈʤɛstəd
inhabited	ɪnˈhæbətəd
inherited	ɪnˈhɛrətɪd
inhibited	ɪnˈhɪbətɪd
initialed	ɪˈnɪʃəld
initiated	ɪˈnɪʃiˌeɪtəd
injected	ɪnˈʤɛktəd
injured	ˈɪnʤərd
inquired	ɪnˈkwaɪərd
inscribed	ɪnˈskraɪbd
inserted	ɪnˈsɜrtəd
insinuated	ɪnˈsɪnjueɪtɪd
insisted	ɪnˈsɪstəd
inspected	ɪnˈspɛktɪd
inspired	ɪnˈspaɪərd
installed	ɪnˈstɔld
instituted	ˈɪnstəˌtutəd
institutionalized	ˌɪnstɪˈtuʃənəlaɪzd
instructed	ɪnˈstrʌktəd
insulated	ˈɪnsəˌleɪtəd
insulted	ɪnˈsʌltɪd
insured	ɪnˈʃʊrd
integrated	ˈɪntəˌgreɪtəd
intended	ɪnˈtɛndəd
intensified	ɪnˈtɛnsəˌfaɪd
intentioned	ɪnˈtɛnʧənd
intercepted	ˌɪntərˈsɛptəd
interconnected	ˌɪntərkəˈnɛktɪd
interested	ˈɪntrəstəd
interfered	ˌɪntərˈfɪrd
interjected	ˌɪntərˈʤɛktɪd
interlaced	ˌɪntərˈleɪst
intermeshed	ˌɪntərˈmɛʃt
internalized	ɪnˈtɜrnəˌlaɪzd
internationalized	ɪntərˈnæʃənəlaɪzd
interned	ˈɪnˌtɜrnd
interpolated	ˌɪˈtɜrpəˌleɪtɪd
interposed	ˌɪntərˈpoʊzd
interpreted	ɪnˈtɜrprətəd
interred	ˌɪnˈtɜrd
interrelated	ˌɪntərrɪˈleɪtɪd
interrupted	ˌɪntəˈrʌptɪd
interspersed	ˌɪntərˈspɜrst
intertwined	ɪntərˈtwaɪnd
intervened	ˌɪntərˈvind
interviewed	ˈɪntərˌvjud
intimated	ˈɪntəˌmeɪtɪd
intimidated	ɪnˈtɪmɪˌdeɪtɪd
intoned	ɪnˈtoʊnd
intoxicated	ɪnˈtɑksəˌkeɪtəd
intrigued	ˈɪntrigd
introduced	ˌɪntrəˈdust
introverted	ˈɪntroʊˌvɜrtɪd
intruded	ɪnˈtrudəd
inundated	ˈɪnənˌdeɪtɪd
inured	ɪnˈjʊrd
invaded	ɪnˈveɪdəd
invalidated	ɪnˈvæləˌdeɪtəd
invented	ɪnˈvɛntəd
inverted	ɪnˈvɜrtɪd
invested	ɪnˈvɛstəd
investigated	ɪnˈvɛstəˌgeɪtəd
invited	ɪnˈvaɪtəd
invoked	ɪnˈvoʊkt
involved	ɪnˈvɑlvd
ionized	ˈaɪəˌnaɪzd
ironed	ˈaɪərnd
irradiated	ɪˈreɪdiˌeɪtɪd
irritated	ˈɪrəˌteɪtəd
isolated	ˈaɪsəˌleɪtəd
issued	ˈɪʃud
italicized	ɪˈtælɪˌsaɪzd
itemized	ˈaɪtəˌmaɪzd
jabbed	ʤæbd
jacketed	ˈʤækətɪd
jaded	ˈʤeɪdəd
jagged	ʤægd
jailed	ʤeɪld
jammed	ʤæmd
jarred	ʤɑrd
jerked	ʤɜrkt
jeweled	ˈʤuəld
jewelled	ˈʤuɪld
jilted	ˈʤɪltɪd
jingled	ˈʤɪŋgəld
joined	ʤɔɪnd
joked	ʤoʊkt
jotted	ˈʤɑtɪd
journeyed	ˈʤɜrnid
judged	ʤʌʤd
jumbled	ˈʤʌmbəld
jumped	ʤʌmpt
justified	ˈʤʌstəˌfaɪd
juxtaposed	ˌʤʌkstəˈpoʊzd
kept	kɛpt
keyed	kid
kicked	kɪkt
kidded	ˈkɪdɪd
kidnapped	ˈkɪdˌnæpt
killed	kɪld
kindled	ˈkɪndəld
kissed	kɪst
kneeled	nild
knelt	nɛlt
knew	nu
knitted	ˈnɪtəd
knocked	nɑkt
knotted	ˈnɑtɪd
knuckled	ˈnʌkəld
labeled	ˈleɪbəld
labelled	ˈleɪbəld
labored	ˈleɪbərd
laced	leɪst
lacerated	ˈlæsəˌreɪtɪd
lacked	lækt
lacquered	ˈlækərd
lagged	lægd
laid	leɪd
laminated	ˈlæməˌneɪtəd
lanced	lænst
landed	ˈlændəd
landscaped	ˈlændˌskeɪpt
languished	ˈlæŋgwɪʃt
lapped	læpt
lapsed	læpst
lashed	læʃt
lasted	ˈlæstəd
latched	læʧt
lathered	ˈlæðərd
laughed	læft
launched	lɔnʧt
laundered	ˈlɔndərd
lavished	ˈlævɪʃt
lay	leɪ
layered	ˈleɪərd
leaded	ˈlɛdɪd
leafed	lift
leagued	ligd
leaked	likt
leaned	lind
leaped	lɛpt
leapt	lɛpt
learned	lɜrnd
leased	list
leathered	ˈlɛðərd
leavened	ˈlɛvənd
lectured	ˈlɛkʧərd
led	lɛd
leered	lɪrd
left	lɛft
legalized	ˈligəˌlaɪzd
legged	ˈlɛgəd
legislated	ˈlɛʤəˌsleɪtəd
legitimized	lɪˈʤɪtəˌmaɪzd
lengthened	ˈlɛŋθənd
lent	lɛnt
lessened	ˈlɛsənd
lettered	ˈlɛtərd
leveled	ˈlɛvəld
levelled	ˈlɛvəld
levied	ˈlɛvid
liberated	ˈlɪbəˌreɪtɪd
licensed	ˈlaɪsənst
licked	lɪkt
lied	laɪd
lifted	ˈlɪftəd
lighted	ˈlaɪtəd
lightened	ˈlaɪtənd
liked	laɪkt
likened	ˈlaɪkənd
limited	ˈlɪmətəd
limped	lɪmpt
lined	laɪnd
lingered	ˈlɪŋgərd
linked	lɪŋkt
liquidated	ˈlɪkwɪˌdeɪtɪd
listed	ˈlɪstəd
listened	ˈlɪsənd
lit	lɪt
littered	ˈlɪtərd
lived	laɪvd
liveried	ˈlɪvrid
loaded	ˈloʊdəd
loafed	loʊft
loaned	loʊnd
loathed	loʊðd
lobbied	ˈlɑbid
localized	ˈloʊkəˌlaɪzd
located	ˈloʊˌkeɪtəd
locked	lɑkt
lodged	lɑʤd
logged	lɔgd
longed	lɔŋd
looked	lʊkt
loomed	lumd
looped	lupt
loosened	ˈlusənd
looted	ˈlutəd
loped	loʊpt
lopped	lɑpt
lost	lɔst
lounged	laʊnʤd
loused	laʊzd
loved	lʌvd
lowered	ˈloʊərd
lubricated	ˈlubrəˌkeɪtɪd
lucked	lʌkt
lugged	lʌgd
lulled	lʌld
lumbered	ˈlʌmbərd
lumped	lʌmpt
lunged	lʌnʤd
lurched	lɜrʧt
lured	lʊrd
lurked	lɜrkt
lynched	lɪnʧt
made	meɪd
magnetized	ˈmægnɪˌtaɪzd
magnified	ˈmægnəˌfaɪd
mailed	meɪld
maimed	meɪmd
maintained	meɪnˈteɪnd
majored	ˈmeɪʤərd
maladjusted	ˌmæləˈʤʌstɪd
malformed	ˌmælˈfɔrmd
maligned	məˈlaɪnd
malnourished	mælˈnɜrɪʃt
malted	ˈmɔltəd
managed	ˈmænəʤd
mandated	ˈmænˌdeɪtɪd
maneuvered	məˈnuvərd
mangled	ˈmæŋgəld
manifested	ˈmænəˌfɛstəd
manipulated	məˈnɪpjəˌleɪtɪd
manned	mænd
mannered	ˈmænərd
manufactured	ˌmænjəˈfækʧərd
mapped	mæpt
marched	mɑrʧt
marinated	ˈmɛrəˌneɪtɪd
marked	mɑrkt
marketed	ˈmɑrkətəd
marooned	məˈrund
marred	mɑrd
married	ˈmɛrid
marshalled	ˈmɑrʃəld
marveled	ˈmɑrvɛld
marvelled	mɑrˈvɛld
mashed	mæʃt
masked	mæskt
massacred	ˈmæsəkərd
massed	mæst
mastered	ˈmæstərd
matched	mæʧt
mated	ˈmeɪtɪd
materialized	məˈtɪriəˌlaɪzd
matriculated	məˈtrɪkjəleɪtəd
matted	ˈmætɪd
mattered	ˈmætərd
matured	məˈtjʊrd
maximized	ˈmæksəˌmaɪzd
meandered	miˈændərd
meant	mɛnt
measured	ˈmɛʒərd
mechanized	ˈmɛkəˌnaɪzd
meditated	ˈmɛdəˌteɪtɪd
mellowed	ˈmɛloʊd
melted	ˈmɛltəd
memorialized	məˈmɔriəˌlaɪzd
memorized	ˈmɛməˌraɪzd
menaced	ˈmɛnəst
mended	ˈmɛndɪd
mentioned	ˈmɛnʃənd
merged	mɜrʤd
merited	ˈmɛrɪtɪd
mesmerized	ˈmɛzməˌraɪzd
messed	mɛst
met	mɛt
metabolized	məˈtæbəˌlaɪzd
metamorphosed	ˌmɛtəˈmɔrfoʊzd
metered	ˈmitərd
mewed	mjud
migrated	ˈmaɪˌgreɪtɪd
minced	mɪnst
minded	ˈmaɪndəd
mined	maɪnd
mineralized	ˈmɪnərəˌlaɪzd
mingled	ˈmɪŋgəld
minimized	ˈmɪnəˌmaɪzd
ministered	ˈmɪnəstərd
mirrored	ˈmɪrərd
misbranded	mɪsˈbrændəd
miscalculated	mɪsˈkælkjəˌleɪtɪd
miscarried	mɪsˈkɛrid
misconstrued	ˌmɪskənˈstrud
misfired	mɪsˈfaɪərd
misguided	mɪsˈgaɪdɪd
misinterpreted	mɪsɪnˈtɜrprətɪd
misjudged	mɪsˈʤʌʤd
mismanaged	mɪsˈmænɪʤd
misnamed	mɪsˈneɪmd
misplaced	mɪsˈpleɪst
misquoted	mɪsˈkwoʊtɪd
missed	mɪst
mistaken	mɪsˈteɪkən
misted	ˈmɪstɪd
mistook	mɪsˈtʊk
mistrusted	mɪsˈtrʌstɪd
mixed	mɪkst
moaned	moʊnd
mobilized	ˈmoʊbəˌlaɪzd
mocked	mɑkt
modeled	ˈmɑdəld
modernized	ˈmɑdərˌnaɪzd
modified	ˈmɑdəˌfaɪd
modulated	ˈmɔʤjuleɪtɪd
moistened	ˈmɔɪsənd
molded	ˈmoʊldəd
mollified	ˈmɑləˌfaɪd
moneyed	ˈmʌnid
monitored	ˈmɑnətərd
mooed	mud
moored	mʊrd
mopped	mɑpt
mortared	ˈmɔrtərd
mothered	ˈmʌðərd
motioned	ˈmoʊʃənd
motivated	ˈmoʊtəˌveɪtəd
mounded	ˈmaʊndɪd
mounted	ˈmaʊntəd
mourned	mɔrnd
mouthed	maʊðd
moved	muvd
mowed	moʊd
muddied	ˈmʌdid
muffled	ˈmʌfəld
mugged	mʌgd
multicolored	ˌmʌltiˈkʌlərd
multiplied	ˈmʌltəˌplaɪd
mumbled	ˈmʌmbəld
mummified	ˈmʌmɪˌfaɪd
munched	mʌnʧt
murdered	ˈmɜrdərd
murmured	ˈmɜrmərd
muscled	ˈmʌsəld
mused	mjuzd
mustached	ˈmʌˌstæʃt
mustered	ˈmʌstərd
muted	ˈmjutɪd
mutilated	ˈmjutəˌleɪtəd
muttered	ˈmʌtərd
mystified	ˈmɪstəˌfaɪd
nabbed	næbd
nagged	nægd
nailed	neɪld
named	neɪmd
napped	næpt
narrated	ˈnɛˌreɪtɪd
narrowed	ˈnɛroʊd
nationalized	ˈnæʃənəˌlaɪzd
naturalized	ˈnæʧərəˌlaɪzd
natured	ˈneɪʧərd
nauseated	ˈnɔziˌeɪtəd
neared	nɪrd
necessitated	nəˈsɛsəˌteɪtəd
needed	ˈnidəd
needled	ˈnidəld
neglected	nəˈglɛktəd
negotiated	nəˈgoʊʃiˌeɪtəd
nested	ˈnɛstəd
nestled	ˈnɛsəld
netted	ˈnɛtɪd
nettled	ˈnɛtəld
neutralized	ˈnutrəˌlaɪzd
nicked	nɪkt
nighted	ˈnaɪtɪd
nipped	nɪpt
nodded	ˈnɑdəd
nominated	ˈnɑməˌneɪtəd
noncommissioned	ˌnɑnkəˈmɪʃənd
nonplussed	nɑnˈplʌst
normalized	ˈnɔrməˌlaɪzd
notarized	ˈnoʊtəˌraɪzd
notched	nɑʧt
noted	ˈnoʊtəd
noticed	ˈnoʊtəst
notified	ˈnoʊtəˌfaɪd
nourished	ˈnɜrɪʃt
novelized	ˈnɑvəˌlaɪzd
nudged	nʌʤd
nullified	ˈnʌləˌfaɪd
numbered	ˈnʌmbərd
nuzzled	ˈnʌzəld
obeyed	oʊˈbeɪd
objected	əbˈʤɛktəd
obligated	ˈɑbləˌgeɪtɪd
obliged	əˈblaɪʤd
obliterated	əˈblɪtəˌreɪtɪd
obscured	əbˈskjʊrd
observed	əbˈzɜrvd
obsessed	əbˈsɛst
obstructed	əbˈstrʌktɪd
obtained	əbˈteɪnd
occasioned	əˈkeɪʒənd
occluded	əˈkludɪd
occupied	ˈɑkjəˌpaɪd
occurred	əˈkɜrd
offended	əˈfɛndəd
offered	ˈɔfərd
officered	ˈɔfəsərd
officiated	əˈfɪʃiˌeɪtəd
ogled	ˈoʊgəld
oiled	ɔɪld
omitted	oʊˈmɪtəd
oozed	uzd
opened	ˈoʊpənd
operated	ˈɑpəˌreɪtəd
opposed	əˈpoʊzd
oppressed	əˈprɛst
opted	ˈɑptɪd
ordained	ɔrˈdeɪnd
ordered	ˈɔrdərd
organized	ˈɔrgəˌnaɪzd
oriented	ˈɔriˌɛntəd
originated	əˈrɪʤəˌneɪtəd
ornamented	ˈɔrnəˌmɛntɪd
orphaned	ˈɔrfənd
ostracized	ˈɔstrəˌsaɪzd
ousted	ˈaʊstɪd
overburdened	ˈoʊvərˈbɜrdənd
overcame	ˈoʊvərˈkeɪm
overcome	ˈoʊvərˌkʌm
overcooked	ˌoʊvərˈkʊkt
overcrowded	ˈoʊvərˌkraʊdɪd
overdeveloped	ˌoʊvərdɪˈvɛləpt
overemphasized	ˈoʊvəˈrɛmfəˌsaɪzd
overestimated	ˌoʊvəˈrɛstəˌmeɪtɪd
overexcited	ˌoʊvərɛkˈsaɪtɪd
overflowed	ˌoʊvərˈfloʊd
overheated	ˈoʊvərˌhitɪd
overindulged	ˌoʊvərɪnˈdʌlʤd
overlaid	ˈoʊvərˌleɪd
overlapped	ˈoʊvərˌlæpt
overloaded	ˈoʊvərˌloʊdɪd
overlooked	ˈoʊvərˌlʊkt
overpaid	ˈoʊvərˈpeɪd
overplayed	ˈoʊvərˈpleɪd
overpopulated	ˌoʊvərˈpɑpjəleɪtɪd
overpowered	ˌoʊvərˈpaʊərd
overpriced	ˈoʊvərˌpraɪst
overrated	ˌoʊvərˈreɪtɪd
overreached	ˈoʊvərˌriʧt
oversexed	ˌoʊvərˈsɛkst
overshadowed	ˌoʊvərˈʃædoʊd
oversimplified	oʊvərˈsɪmplɪˌfaɪd
oversized	ˈoʊvərˌsaɪzd
oversubscribed	ˌoʊvərsəbˈskraɪbd
overtaken	ˈoʊvərˌteɪkən
overtaxed	ˌoʊvərˈtækst
overtook	ˌoʊvərˈtʊk
overturned	ˈoʊvərˌtɜrnd
overwhelmed	ˌoʊvərˈwɛlmd
overworked	ˌoʊvərˈwɜrkt
owed	oʊd
owned	oʊnd
oxidised	ˈɑksəˌdaɪzd
paced	peɪst
packaged	ˈpækɪʤd
packed	pækt
padded	ˈpædəd
padlocked	ˈpæˌdlɑkt
paginated	ˈpæʤəˌneɪtɪd
paid	peɪd
pained	peɪnd
painted	ˈpeɪntəd
paired	pɛrd
paled	peɪld
palmed	pɑmd
pampered	ˈpæmpərd
paneled	ˈpænəld
panicked	ˈpænɪkt
panted	ˈpæntɪd
pantomimed	ˈpæntəˌmaɪmd
paraded	pəˈreɪdɪd
paralleled	ˈpɛrəˌlɛld
paralyzed	ˈpɛrəˌlaɪzd
parceled	ˈpɑrsəld
parched	pɑrʧt
pardoned	ˈpɑrdənd
parked	pɑrkt
parodied	ˈpɛrədid
parried	ˈpɛrid
parted	ˈpɑrtəd
participated	pɑrˈtɪsəˌpeɪtəd
partnered	ˈpɑrtnərd
passed	pæst
pasted	ˈpeɪstɪd
patched	pæʧt
patented	ˈpætəntəd
patrolled	pəˈtroʊld
patronized	ˈpeɪtrəˌnaɪzd
patted	ˈpætəd
pattered	ˈpætərd
patterned	ˈpætərnd
paused	pɔzd
paved	peɪvd
peaked	pikt
pecked	pɛkt
peddled	ˈpɛdəld
pedigreed	ˈpɛdəgrid
peed	pid
peeked	pikt
peeled	pild
peered	pɪrd
pegged	pɛgd
penalized	ˈpinəˌlaɪzd
penciled	ˈpɛnsəld
penetrated	ˈpɛnəˌtreɪtəd
penned	pɛnd
peopled	ˈpipəld
peppered	ˈpɛpərd
perceived	pərˈsivd
perched	pɜrʧt
perfected	pərˈfɛktəd
perforated	ˈpɜrfəˌreɪtəd
performed	pərˈfɔrmd
perfumed	pərˈfjumd
perished	ˈpɛrɪʃt
permeated	ˈpɜrmiˌeɪtɪd
permitted	pərˈmɪtəd
perpetrated	ˈpɜrpəˌtreɪtɪd
perpetuated	pərˈpɛʧəˌweɪtɪd
perplexed	pərˈplɛkst
persecuted	ˈpɜrsəˌkjutəd
persisted	pərˈsɪstəd
personalized	ˈpɜrsənəˌlaɪzd
personified	pərˈsɑnəˌfaɪd
perspired	pərˈspaɪrd
persuaded	pərˈsweɪdəd
pertained	pərˈteɪnd
perturbed	pərˈtɜrbd
pervaded	pərˈveɪdɪd
perverted	pərˈvɜrtɪd
petered	ˈpitərd
petitioned	pəˈtɪʃənd
petrified	ˈpɛtrəˌfaɪd
petted	ˈpɛtəd
philosophized	fɪˈlɑsəˌfaɪzd
phoned	foʊnd
photographed	ˈfoʊtəˌgræft
phrased	freɪzd
picked	pɪkt
picketed	ˈpɪkətɪd
pickled	ˈpɪkəld
picnicked	ˈpɪkˌnɪkt
pictured	ˈpɪkʧərd
pierced	pɪrst
pigmented	ˈpɪgməntɪd
piled	paɪld
pillaged	ˈpɪlɪʤd
pillared	ˈpɪlərd
pimpled	ˈpɪmpəld
pinched	pɪnʧt
pinioned	ˈpɪnjənd
pinned	pɪnd
pioneered	ˌpaɪəˈnɪrd
piped	paɪpt
pitched	pɪʧt
pitied	ˈpɪˌtid
placed	pleɪst
plagued	pleɪgd
planed	pleɪnd
planned	plænd
planted	ˈplæntəd
plastered	ˈplæstərd
plated	ˈpleɪtəd
played	pleɪd
pleaded	ˈplidəd
pleased	plizd
pledged	plɛʤd
plied	plaɪd
plodded	ˈplɑdəd
plopped	plɑpt
plotted	ˈplɑtəd
plowed	plaʊd
plucked	plʌkt
plugged	plʌgd
plumbed	plʌmd
plumed	plumd
plumped	plʌmpt
plunged	plʌnʤd
pocketed	ˈpɑkətɪd
pointed	ˈpɔɪntəd
poised	pɔɪzd
poisoned	ˈpɔɪzənd
poked	poʊkt
polarized	ˈpoʊləˌraɪzd
policed	pəˈlist
polished	ˈpɑlɪʃt
polled	poʊld
polluted	pəˈlutəd
pondered	ˈpɑndərd
pooled	puld
popped	pɑpt
populated	ˈpɑpjəˌleɪtəd
pored	pɔrd
portended	pɔrˈtɛndɪd
portrayed	pɔrˈtreɪd
posed	poʊzd
positioned	pəˈzɪʃənd
possessed	pəˈzɛst
posted	ˈpoʊstɪd
postponed	poʊstˈpoʊnd
postulated	ˈpɑsʧəˌleɪtɪd
potted	ˈpɑtɪd
pounded	ˈpaʊndɪd
poured	pɔrd
pouted	ˈpaʊtɪd
powdered	ˈpaʊdərd
powered	ˈpaʊərd
practiced	ˈpræktəst
practised	ˈpræktɪst
praised	preɪzd
prayed	preɪd
preached	priʧt
prearranged	ˌpriəˈreɪnʤd
preceded	prɪˈsidɪd
precipitated	prɪˈsɪpɪˌteɪtɪd
precluded	prɪˈkludɪd
preconceived	ˌprikənˈsivd
preconditioned	ˌprikənˈdɪʃənd
precooked	priˈkʊkt
predestined	ˌpriˈdɛstənd
predetermined	ˌpridiˈtɜrmɪnd
predicted	prɪˈdɪktɪd
predigested	ˌpridaɪˈʤɛstəd
predisposed	ˌpridɪˈspoʊzd
predominated	prɪˈdɑməˌneɪtɪd
prefabricated	priˈfæbrɪˌkeɪtɪd
prefaced	ˈprɛfəst
preferred	prəˈfɜrd
prejudged	priˈʤʌʤd
prejudiced	ˈprɛʤədəst
preoccupied	priˈɑkjəˌpaɪd
prepackaged	priˈpækəʤd
prepared	priˈpɛrd
prescribed	priˈskraɪbd
presented	priˈzɛntəd
preserved	prəˈzɜrvd
presided	prɪˈzaɪdɪd
pressed	prɛst
presumed	prəˈzumd
presupposed	ˌprisəˈpoʊzd
pretended	priˈtɛndəd
prevailed	prɪˈveɪld
prevented	prɪˈvɛntɪd
priced	praɪst
pricked	prɪkt
primed	praɪmd
printed	ˈprɪntəd
privileged	ˈprɪvləʤd
prized	praɪzd
probed	proʊbd
proceeded	prəˈsidəd
processed	ˈprɑsɛst
proclaimed	proʊˈkleɪmd
procured	proʊˈkjʊrd
prodded	ˈprɑdɪd
produced	prəˈdust
professed	prəˈfɛst
proffered	ˈprɑfərd
profited	ˈprɑfətəd
programmed	ˈproʊˌgræmd
progressed	prəˈgrɛst
prohibited	proʊˈhɪbətəd
projected	prəˈʤɛktəd
proliferated	prəˈlɪfəˌreɪtɪd
prolonged	prəˈlɔŋd
promised	ˈprɑməst
promoted	prəˈmoʊtəd
prompted	ˈprɑmptəd
pronounced	prəˈnaʊnst
propagated	ˈprɑpəˌgeɪtɪd
propelled	prəˈpɛld
prophesied	ˈprɑfəˌsaɪd
proposed	prəˈpoʊzd
propositioned	ˌprɑpəˈzɪʃənd
propped	prɑpt
proscribed	proʊˈskraɪbd
prosecuted	ˈprɑsɪˌkjutɪd
prospered	ˈprɑspərd
protected	prəˈtɛktəd
protested	prəˈtɛstəd
protracted	proʊˈtræktɪd
protruded	proʊˈtrudɪd
proved	pruvd
provided	prəˈvaɪdəd
provisioned	prəˈvɪʒənd
provoked	prəˈvoʊkt
prowled	praʊld
pruned	prund
publicized	ˈpʌblɪˌsaɪzd
published	ˈpʌblɪʃt
puckered	ˈpʌkərd
puffed	pʌft
pulled	pʊld
pulsed	pʌlst
pulverized	ˈpʌlvəˌraɪzd
pummeled	ˈpʌməld
pumped	pʌmpt
punched	pʌnʧt
punctuated	ˈpʌŋkʧuˌeɪtɪd
punctured	ˈpʌŋkʧərd
punished	ˈpʌnɪʃt
punted	ˈpʌntɪd
pupated	ˈpjuˌpeɪtɪd
purchased	ˈpɜrʧəst
purged	pɜrʤd
purified	ˈpjʊrəˌfaɪd
purported	pərˈpɔrtɪd
purposed	ˈpɜrpəst
pursed	pɜrst
pursued	pərˈsud
pushed	pʊʃt
putted	ˈpʌtɪd
puzzled	ˈpʌzəld
quacked	kwækt
quadrupled	kwɑˈdrupəld
qualified	ˈkwɑləˌfaɪd
quarreled	ˈkwɔrəld
quashed	kwɔʃt
queried	ˈkwɪrid
questioned	ˈkwɛsʧənd
queued	kjud
quickened	ˈkwɪkənd
quieted	ˈkwaɪətəd
quilted	ˈkwɪltɪd
quivered	ˈkwɪvərd
quoted	ˈkwoʊtɪd
raced	reɪst
racked	rækt
radiated	ˈreɪdiˌeɪtəd
radioed	ˈreɪdiˌoʊd
raftered	ˈræftərd
raged	reɪʤd
ragged	ˈrægəd
raided	ˈreɪdɪd
rained	reɪnd
raised	reɪzd
raked	reɪkt
rallied	ˈrælid
rammed	ræmd
ran	ræn
rang	ræŋ
ranged	reɪnʤd
ranked	ræŋkt
ransacked	ˈrænˌsækt
ranted	ˈræntəd
raped	reɪpt
rapped	ræpt
rasped	ræspt
rated	ˈreɪtəd
ratified	ˈrætəˌfaɪd
rationalized	ˈræʃənəˌlaɪzd
rationed	ˈræʃənd
rattled	ˈrætəld
reached	riʧt
reacquainted	ˌriəˈkweɪntɪd
reacted	riˈæktəd
reactivated	ˈriˈæktəˌveɪtɪd
readjusted	ˌriəˈʤʌstɪd
reaffirmed	ˌriəˈfɜrmd
realized	ˈriəˌlaɪzd
reaped	ript
reappeared	ˌriəˈpɪrd
reapportioned	ˌriəˈpɔrʃənd
reared	rɪrd
rearmed	ˈriˈɑrmd
rearranged	ˌriəˈreɪnʤd
reasoned	ˈrizənd
reassembled	ˌriəˈsɛmbəld
reassured	ˌriəˈʃʊrd
rebelled	rɪˈbɛld
rebuffed	rɪˈbʌft
rebuked	rɪˈbjukt
rebutted	rɪˈbʌtɪd
recalculated	riˈkælkjəˌleɪtɪd
recalled	rɪˈkɔld
recanted	riˈkæntɪd
recaptured	riˈkæpʧərd
receded	rəˈsidəd
received	rəˈsivd
recessed	rɪˈsɛst
recited	rəˈsaɪtəd
reckoned	ˈrɛkənd
reclaimed	riˈkleɪmd
reclassified	riˈklæsəˌfaɪd
recognized	ˈrɛkəgˌnaɪzd
recoiled	riˈkɔɪld
recollected	ˌrɛkəˈlɛktɪd
recommended	ˌrɛkəˈmɛndəd
reconciled	ˈrɛkənˌsaɪld
reconsidered	ˌrikənˈsɪdərd
reconstructed	ˌrikənˈstrʌktɪd
reconvened	rikənˈvind
recopied	ˌriˈkɑpid
recorded	rəˈkɔrdəd
recounted	rɪˈkaʊntɪd
recouped	rɪˈkupt
recovered	rəˈkʌvərd
recreated	ˈrɛkriˌeɪtɪd
recruited	rɪˈkrutɪd
recurred	riˈkɜrd
reddened	ˈrɛdənd
redecorated	riˈdɛkəˌreɪtɪd
redeemed	rɪˈdimd
redefined	ridɪˈfaɪnd
redistributed	ˌridɪˈstrɪbjutɪd
redoubled	riˈdʌbəld
redressed	rɪˈdrɛst
reduced	rəˈdust
reeked	rikt
reelected	riɪˈlɛktəd
reeled	rild
reemerged	riɪˈmɜrʤd
reentered	riˈɪntərd
referred	rəˈfɜrd
refilled	riˈfɪld
refined	rəˈfaɪnd
reflected	rəˈflɛktəd
refolded	ˌriˈfoʊldəd
reformed	rɪˈfɔrmd
reformulated	riˈfɔrmjəˌleɪtɪd
refracted	rɪˈfræktəd
refrained	rɪˈfreɪnd
refreshed	riˈfrɛʃt
refrigerated	rɪˈfrɪʤəˌreɪtɪd
refunded	rɪˈfʌndɪd
refurbished	riˈfɜrbɪʃt
refused	rəˈfjuzd
refuted	rɪˈfjutɪd
regained	riˈgeɪnd
regaled	rɪˈgeɪld
regarded	rəˈgɑrdəd
regimented	ˈrɛʤəˌmɛntɪd
registered	ˈrɛʤɪstərd
regretted	rɪˈgrɛtɪd
regrouped	riˈgrupt
regulated	ˈrɛgjəˌleɪtəd
rehearsed	riˈhɜrst
reigned	reɪnd
reimbursed	ˌriɪmˈbɜrst
reincarnated	ˌriɪnˈkɑrˌneɪtɪd
reined	reɪnd
reinforced	ˌriɪnˈfɔrst
reinstated	ˌriɪnˈsteɪtɪd
reinterpreted	riɪnˈtɜrprətɪd
reiterated	riˈɪtəˌreɪtɪd
rejected	rɪˈʤɛktɪd
rejoiced	rɪˈʤɔɪst
relaid	ˌriˈleɪd
related	rɪˈleɪtɪd
relaxed	rɪˈlækst
relayed	ˈriˌleɪd
released	riˈlist
relegated	ˈrɛləˌgeɪtɪd
relented	rɪˈlɛntɪd
relied	rɪˈlaɪd
relieved	rɪˈlivd
relinquished	rɪˈlɪŋkwɪʃt
reloaded	riˈloʊdɪd
remained	rɪˈmeɪnd
remanded	rɪˈmændɪd
remarked	rɪˈmɑrkt
remarried	riˈmɛrid
remembered	rɪˈmɛmbərd
reminded	riˈmaɪndəd
reminisced	ˌrɛməˈnɪst
remitted	riˈmɪtɪd
remodeled	riˈmɑdəld
remonstrated	rɪˈmɑnˌstreɪtɪd
removed	riˈmuvd
renamed	riˈneɪmd
rendered	ˈrɛndərd
renewed	rɪˈnud
renovated	ˈrɛnəˌveɪtɪd
renowned	rɪˈnaʊnd
rented	ˈrɛntəd
reopened	riˈoʊpənd
reorganized	riˈɔrgəˌnaɪzd
reoriented	riˈɔriɛntɪd
repaid	riˈpeɪd
repaired	rɪˈpɛrd
repealed	rɪˈpild
repeated	rɪˈpitɪd
repelled	rəˈpɛld
rephrased	riˈfreɪzd
replaced	ˌriˈpleɪst
replanted	riˈplæntɪd
replenished	riˈplɛnɪʃt
replied	rɪˈplaɪd
reported	ˌriˈpɔrtəd
reposed	riˈpoʊzd
represented	ˌrɛprəˈzɛntəd
repressed	riˈprɛst
reprimanded	ˈrɛprəˌmændɪd
reprinted	riˈprɪntɪd
reproduced	ˌriprəˈdust
repudiated	riˈpjudiˌeɪtəd
repulsed	riˈpʌlst
reputed	rɪˈpjutɪd
requested	rɪˈkwɛstɪd
required	riˈkwaɪərd
requisitioned	ˌrɛkwəˈzɪʃənd
rescinded	rɪˈsɪndɪd
rescued	ˈrɛskjud
resealed	riˈsild
resembled	rɪˈzɛmbəld
resented	riˈzɛntəd
reserved	rɪˈzɜrvd
reshaped	riˈʃeɪpt
resided	rɪˈzaɪdɪd
resigned	rɪˈzaɪnd
resisted	rɪˈzɪstɪd
resolved	riˈzɑlvd
resorted	rɪˈzɔrtɪd
respected	rɪˈspɛktɪd
responded	rɪˈspɑndɪd
rested	ˈrɛstəd
restored	rɪˈstɔrd
restrained	riˈstreɪnd
restricted	riˈstrɪktəd
restructured	riˈstrʌkʧərd
resulted	rɪˈzʌltɪd
resumed	rɪˈzumd
resurrected	ˌrɛzəˈrɛktɪd
resuspended	ˌrisəˈspɛndəd
retained	rɪˈteɪnd
retaliated	rɪˈtæliˌeɪtɪd
retarded	rɪˈtɑrdɪd
retied	ˌriˈtaɪd
retired	rɪˈtaɪrd
retorted	riˈtɔrtɪd
retraced	riˈtreɪst
retracted	riˈtræktəd
retranslated	ˌritrænˈzleɪtəd
retreated	riˈtritəd
retrieved	riˈtrivd
returned	rɪˈtɜrnd
reunited	ˌriuˈnaɪtɪd
revamped	riˈvæmpt
revealed	rɪˈvild
reveled	ˈrɛvəld
reverberated	rɪˈvɜrbəˌreɪtɪd
revered	rɪˈvɪrd
reversed	rɪˈvɜrst
reverted	rɪˈvɜrtɪd
reviewed	riˈvjud
reviled	riˈvaɪld
revised	rɪˈvaɪzd
revisited	riˈvɪzətɪd
revived	rɪˈvaɪvd
revivified	riˈvɪvəˌfaɪd
revoked	rɪˈvoʊkt
revolted	rɪˈvoʊltɪd
revolutionized	ˌrɛvəˈluʃəˌnaɪzd
revolved	riˈvɑlvd
revved	rɛvd
rewarded	rɪˈwɔrdɪd
ribbed	rɪbd
ricocheted	ˈrɪkəˌʃeɪd
rid	rɪd
ridden	ˈrɪdən
riddled	ˈrɪdəld
ridiculed	ˈrɪdəˌkjuld
rifled	ˈraɪfəld
rigged	rɪgd
rimmed	rɪmd
ringed	rɪŋd
rioted	ˈraɪətɪd
ripened	ˈraɪpənd
ripped	rɪpt
rippled	ˈrɪpəld
risen	ˈrɪzən
risked	rɪskt
ritualized	ˈrɪtʃuəˌlaɪzd
rivaled	ˈraɪvəld
rivalled	ˈraɪvəld
roamed	roʊmd
roared	rɔrd
roasted	ˈroʊstəd
robbed	rɑbd
robed	roʊbd
rocked	rɑkt
rolled	roʊld
romped	rɑmpt
roofed	ruft
rooted	ˈrutəd
roped	roʊpt
rose	roʊz
rotated	ˈroʊˌteɪtɪd
roughed	rʌft
roughened	ˈrʌfənd
rounded	ˈraʊndəd
roused	raʊzd
routed	ˈrutɪd
roved	roʊvd
rowed	roʊd
rubbed	rʌbd
rubberized	ˈrʌbəˌraɪzd
ruffled	ˈrʌfəld
ruined	ˈruənd
ruled	ruld
rumbled	ˈrʌmbəld
rummaged	ˈrʌmɪʤd
rumored	ˈrumərd
rumpled	ˈrʌmpəld
run	rʌn
rung	rʌŋ
ruptured	ˈrʌpʧərd
rushed	rʌʃt
rusted	ˈrʌstəd
rustled	ˈrʌsəld
rutted	ˈrʌtɪd
sacrificed	ˈsækrəˌfaɪst
saddened	ˈsædənd
saddled	ˈsædəld
sagged	sægd
said	sɛd
sailed	seɪld
sainted	ˈseɪntɪd
salaried	ˈsælərid
salted	ˈsɔltəd
saluted	səˈlutəd
sampled	ˈsæmpəld
sanctified	ˈsæŋktəfaɪd
sanctioned	ˈsæŋkʃənd
sang	sæŋ
sank	sæŋk
sapped	sæpt
sat	sæt
satisfied	ˈsætəˌsfaɪd
saturated	ˈsæʧəˌreɪtəd
sauced	sɔst
saved	seɪvd
savored	ˈseɪvərd
saw	sɔ
scabbed	skæbd
scalded	ˈskɔldɪd
scaled	skeɪld
scalloped	ˈskɑləpt
scandalized	ˈskændəˌlaɪzd
scanned	skænd
scared	skɛrd
scarred	skɑrd
scattered	ˈskætərd
scented	ˈsɛntɪd
scheduled	ˈskɛʤʊld
schooled	skuld
scoffed	skɔft
scooped	skupt
scooted	ˈskutɪd
scoped	skoʊpt
scorched	skɔrʧt
scored	skɔrd
scorned	skɔrnd
scoured	ˈskaʊərd
scouted	ˈskaʊtəd
scowled	skaʊld
scrambled	ˈskræmbəld
scraped	skreɪpt
scrapped	skræpt
scratched	skræʧt
scrawled	skrɔld
screamed	skrimd
screeched	skriʧt
screened	skrind
screwed	skrud
scribbled	ˈskrɪbəld
scrimmaged	ˈskrɪmɪʤd
scrubbed	skrʌbd
scrutinized	ˈskrutəˌnaɪzd
sculpted	ˈskʌlptɪd
sculptured	ˈskʌlpʧərd
scurried	ˈskərid
scuttled	ˈskʌtəld
sealed	sild
searched	sɜrʧt
seasoned	ˈsizənd
seated	ˈsitəd
seceded	sɪˈsidɪd
secluded	sɪˈkludɪd
secreted	səˈkritəd
sectionalized	ˈsɛkʃənəˌlaɪzd
secularized	ˈsɛkjələraɪzd
secured	sɪˈkjʊrd
seduced	sɪˈdust
seemed	simd
seeped	sipt
segregated	ˈsɛgrəˌgeɪtɪd
seized	sizd
selected	səˈlɛktəd
sensed	sɛnst
sensitized	ˈsɛnsəˌtaɪzd
sent	sɛnt
sentenced	ˈsɛntənst
separated	ˈsɛpəˌreɪtəd
sequenced	ˈsikwənst
serenaded	ˌsɛrəˈneɪdɪd
serrated	ˈsɛˌreɪtɪd
served	sɜrvd
settled	ˈsɛtəld
severed	ˈsɛvərd
sewed	soʊd
sexed	sɛkst
sexualized	ˈsɛkʃuəˌlaɪzd
shacked	ʃækt
shackled	ˈʃækəld
shaded	ˈʃeɪdɪd
shadowed	ˈʃædoʊd
shafted	ˈʃæftɪd
shaken	ˈʃeɪkən
shambled	ˈʃæmbəld
shamed	ʃeɪmd
shaped	ʃeɪpt
shared	ʃɛrd
sharpened	ˈʃɑrpənd
shattered	ˈʃætərd
shaved	ʃeɪvd
sheered	ʃɪrd
sheeted	ˈʃitɪd
shelled	ʃɛld
sheltered	ˈʃɛltərd
shelved	ʃɛlvd
shied	ʃaɪd
shielded	ˈʃildɪd
shifted	ˈʃɪftəd
shipped	ʃɪpt
shivered	ˈʃɪvərd
shocked	ʃɑkt
shone	ʃoʊn
shook	ʃʊk
shortened	ˈʃɔrtənd
shot	ʃɑt
shouldered	ˈʃoʊldərd
shouted	ˈʃaʊtəd
shoved	ʃʌvd
shoveled	ˈʃʌvəld
showed	ʃoʊd
showered	ˈʃaʊərd
shrank	ʃræŋk
shredded	ˈʃrɛdəd
shrieked	ʃrikt
shriveled	ˈʃrɪvəld
shrouded	ˈʃraʊdɪd
shrugged	ʃrʌgd
shuddered	ˈʃʌdərd
shuffled	ˈʃʌfəld
shunned	ʃʌnd
shunted	ˈʃʌntɪd
shuttered	ˈʃʌtərd
shuttled	ˈʃʌtəld
sickened	ˈsɪkənd
sided	ˈsaɪdəd
sidled	ˈsaɪdəld
sifted	ˈsɪftɪd
sighed	saɪd
sighted	ˈsaɪtəd
signaled	ˈsɪgnəld
signed	saɪnd
signified	ˈsɪgnəˌfaɪd
silenced	ˈsaɪlənst
silhouetted	ˌsɪləˈwɛtɪd
simmered	ˈsɪmərd
simplified	ˈsɪmpləˌfaɪd
simulated	ˈsɪmjəˌleɪtɪd
singed	sɪnʤd
singled	ˈsɪŋgəld
sinned	sɪnd
siphoned	ˈsaɪfənd
sipped	sɪpt
sired	ˈsaɪərd
situated	ˈsɪʧuˌeɪtɪd
sized	saɪzd
sizzled	ˈsɪzəld
sketched	skɛʧt
skidded	ˈskɪdəd
skilled	skɪld
skimmed	skɪmd
skipped	skɪpt
skirmished	ˈskɜrmɪʃt
skirted	ˈskɜrtɪd
slackened	ˈslækənd
slaked	sleɪkt
slammed	slæmd
slanted	ˈslæntəd
slapped	slæpt
slashed	slæʃt
slated	ˈsleɪtɪd
slatted	ˈslætɪd
slaughtered	ˈslɔtərd
slavered	ˈslævərd
slept	slɛpt
slew	slu
sliced	slaɪst
slid	slɪd
slimed	slaɪmd
slipped	slɪpt
slopped	slɑpt
sloshed	slɑʃt
slotted	ˈslɑtɪd
slowed	sloʊd
slugged	slʌgd
sluiced	slust
slumbered	ˈslʌmbərd
slumped	slʌmpt
slung	slʌŋ
slurped	slɜrpt
smacked	smækt
smarted	ˈsmɑrtəd
smashed	smæʃt
smeared	smɪrd
smelled	smɛld
smelt	smɛlt
smiled	smaɪld
smirked	smɜrkt
smitten	ˈsmɪtən
smoked	smoʊkt
smoldered	ˈsmoʊldərd
smoothed	smuðd
smote	smaɪt
smothered	ˈsmʌðərd
smudged	smʌʤd
smuggled	ˈsmʌgəld
snaked	sneɪkt
snapped	snæpt
snared	snɛrd
snarled	ˈsnɑrəld
snatched	snæʧt
sneaked	snikt
sneered	snɪrd
sneezed	snizd
snickered	ˈsnɪkərd
sniffed	snɪft
snorted	ˈsnɔrtɪd
snowed	snoʊd
snubbed	snʌbd
snuffed	snʌft
snuggled	ˈsnʌgəld
soaked	soʊkt
soared	sɔrd
sobbed	sɑbd
sobered	ˈsoʊbərd
socialized	ˈsoʊʃəˌlaɪzd
socked	sɑkt
softened	ˈsɔfənd
soiled	sɔɪld
solaced	ˈsɑləst
sold	soʊld
soldered	ˈsɑdərd
solicited	səˈlɪsɪtɪd
solved	sɑlvd
soothed	suðd
sophisticated	səˈfɪstəˌkeɪtɪd
sorted	ˈsɔrtɪd
sought	sɔt
sounded	ˈsaʊndəd
spaced	speɪst
spangled	ˈspæŋgəld
spanned	spænd
spared	spɛrd
sparked	spɑrkt
sparkled	ˈspɑrkəld
spattered	ˈspætərd
speared	spird
specialized	ˈspɛʃəˌlaɪzd
specified	ˈspɛsəˌfaɪd
speckled	ˈspɛkəld
speculated	ˈspɛkjəˌleɪtəd
sped	spɛd
speeded	ˈspidɪd
spelled	spɛld
spent	spɛnt
spiced	spaɪst
spiked	spaɪkt
spilled	spɪld
spiraled	ˈspaɪrəld
spirited	ˈspɪrɪtəd
splashed	splæʃt
splattered	ˈsplætərd
splayed	spleɪd
spliced	splaɪst
splintered	ˈsplɪntərd
splotched	splɑtʃt
spoiled	spɔɪld
spoke	spoʊk
spoken	ˈspoʊkən
sponged	spʌnʤd
sponsored	ˈspɑnsərd
spooned	spund
spotted	ˈspɑtəd
spouted	ˈspaʊtəd
sprained	spreɪnd
sprang	spræŋ
sprawled	sprɔld
sprayed	spreɪd
sprinkled	ˈsprɪŋkəld
sprinted	ˈsprɪntɪd
sprouted	ˈspraʊtəd
spruced	sprust
sprung	sprʌŋ
spun	spʌn
spurned	spɜrnd
spurred	spɜrd
sputtered	ˈspʌtərd
squandered	ˈskwɑndərd
squared	skwɛrd
squashed	skwɑʃt
squatted	ˈskwɑtɪd
squeaked	skwikt
squealed	skwild
squeezed	skwizd
squelched	skwɛlʧt
squinted	ˈskwɪntɪd
squirmed	skwɜrmd
squirted	ˈskwɜrtəd
stabbed	stæbd
stabilized	ˈsteɪbəˌlaɪzd
stabled	ˈsteɪbəld
stacked	stækt
staffed	stæft
staged	steɪʤd
staggered	ˈstægərd
stained	steɪnd
staked	steɪkt
stalked	stɔkt
stalled	stɔld
stammered	ˈstæmərd
stamped	stæmpt
stampeded	stæmˈpidəd
standardized	ˈstændərˌdaɪzd
starched	stɑrʧt
stared	stɛrd
starred	stɑrd
started	ˈstɑrtəd
startled	ˈstɑrtəld
starved	stɑrvd
stashed	stæʃt
stated	ˈsteɪtəd
stationed	ˈsteɪʃənd
staved	steɪvd
stayed	steɪd
steadied	ˈstɛdid
steamed	stimd
steeled	stild
steeped	stipt
steered	stɪrd
stemmed	stɛmd
stepped	stɛpt
stereotyped	ˈstɛriəˌtaɪpt
sterilized	ˈstɛrəˌlaɪzd
stewed	stud
stiffened	ˈstɪfənd
stifled	ˈstaɪfəld
stilted	ˈstɪltɪd
stimulated	ˈstɪmjəˌleɪtəd
stirred	stɜrd
stitched	stɪʧt
stoked	stoʊkt
stole	stoʊl
stolen	ˈstoʊlən
stomped	stɑmpt
stoned	stoʊnd
stood	stʊd
stooped	stupt
stopped	stɑpt
stored	stɔrd
stormed	stɔrmd
stowed	stoʊd
straddled	ˈstrædəld
straggled	ˈstrægəld
straightened	ˈstreɪtənd
strained	streɪnd
stranded	ˈstrændəd
strangled	ˈstræŋgəld
strapped	stræpt
stratified	ˈstrætəˌfaɪd
strayed	streɪd
streaked	strikt
streamed	strimd
strengthened	ˈstrɛŋθənd
stressed	strɛst
stretched	strɛʧt
stringed	strɪŋd
striped	straɪpt
stripped	strɪpt
strode	stroʊd
stroked	stroʊkt
strolled	stroʊld
stropped	strɑpt
strove	stroʊv
struck	strʌk
structured	ˈstrʌkʧərd
struggled	ˈstrʌgəld
strung	strʌŋ
strutted	ˈstrʌtɪd
stubbed	stʌbd
stuck	stʌk
studded	ˈstʌdɪd
studied	ˈstʌdid
stuffed	stʌft
stumbled	ˈstʌmbəld
stumped	stʌmpt
stung	stʌŋ
stunk	stʌŋk
stunned	stʌnd
styled	staɪld
stylized	ˈstaɪˌlaɪzd
stymied	ˈstaɪmid
subdued	səbˈdud
subjected	səbˈʤɛktɪd
sublimed	səˈblaɪmd
submerged	səbˈmɜrʤd
submitted	səbˈmɪtəd
subordinated	səˈbɔrdəˌneɪtɪd
subscribed	səbˈskraɪbd
subsided	səbˈsaɪdɪd
subsidized	ˈsʌbsɪˌdaɪzd
substituted	ˈsʌbstəˌtutəd
subsumed	səbˈsumd
subtitled	ˈsʌbˌtaɪtəld
subtracted	səbˈtræktɪd
subverted	səbˈvɜrtɪd
succeeded	səkˈsidəd
succumbed	səˈkʌmd
sucked	sʌkt
sued	sud
suffered	ˈsʌfərd
suffocated	ˈsʌfəˌkeɪtɪd
sugared	ˈʃʊgərd
suggested	səgˈʤɛstəd
suited	ˈsutəd
sulked	sʌlkt
summarized	ˈsʌməˌraɪzd
summed	sʌmd
summoned	ˈsʌmənd
sung	sʌŋ
sunk	sʌŋk
superimposed	ˌsupərəmˈpoʊzd
superposed	ˌsupərˈpoʊzd
superseded	ˌsupərˈsidəd
supervened	ˌsupərˈvind
supervised	ˈsupərˌvaɪzd
supplanted	səˈplæntəd
supplemented	ˈsʌpləˌmɛntəd
supplied	səˈplaɪd
supported	səˈpɔrtəd
supposed	səˈpoʊzd
suppressed	səˈprɛst
surfaced	ˈsɜrfɪst
surged	sɜrʤd
surmised	sərˈmaɪzd
surmounted	sərˈmaʊntɪd
surpassed	sərˈpæst
surprised	sərˈpraɪzd
surrendered	səˈrɛndərd
surrounded	səˈraʊndəd
surveyed	sərˈveɪd
survived	sərˈvaɪvd
suspected	səˈspɛktəd
suspended	səˈspɛndəd
sustained	səˈsteɪnd
swabbed	swɑbd
swaggered	ˈswægərd
swallowed	ˈswɑloʊd
swam	swæm
swamped	swɔmpt
swarmed	swɔrmd
swathed	swɑðd
swayed	sweɪd
sweated	ˈswɛtɪd
swelled	swɛld
swept	swɛpt
swerved	swɜrvd
swindled	ˈswɪndəld
swiped	swaɪpt
swirled	swɜrld
swished	swɪʃt
switched	swɪʧt
swooped	swupt
swore	swɔr
swum	swʌm
swung	swʌŋ
symbolized	ˈsɪmbəˌlaɪzd
sympathized	ˈsɪmpəˌθaɪzd
synchronized	ˈsɪŋkrəˌnaɪzd
syndicated	ˈsɪndɪˌkeɪtɪd
synthesized	ˈsɪnθɪˌsaɪzd
systematized	ˈsɪstəməˌtaɪzd
tabulated	ˈtæbjəˌleɪtɪd
tacked	tækt
tagged	tægd
tailored	ˈteɪlərd
tainted	ˈteɪntɪd
taken	ˈteɪkən
talented	ˈtæləntəd
talked	tɔkt
tangled	ˈtæŋgəld
tanned	tænd
taped	teɪpt
tapered	ˈteɪpərd
tapped	tæpt
tarnished	ˈtɑrnɪʃt
tarred	tɑrd
tasted	ˈteɪstəd
tattered	ˈtætərd
tattooed	tæˈtud
taught	tɔt
taunted	ˈtɔntɪd
taxed	tækst
taxied	ˈtæksid
teamed	timd
teased	tizd
telegraphed	ˈtɛləˌgræft
telephoned	ˈtɛləˌfoʊnd
telescoped	ˈtɛləˌskoʊpt
televised	ˈtɛləˌvaɪzd
tempered	ˈtɛmpərd
tempted	ˈtɛmptəd
tended	ˈtɛndəd
tendered	ˈtɛndərd
tensed	tɛnst
termed	tɜrmd
terminated	ˈtɜrməˌneɪtəd
terraced	ˈtɛrəst
terrified	ˈtɛrəˌfaɪd
terrorized	ˈtɛrəˌraɪzd
tested	ˈtɛstəd
testified	ˈtɛstəˌfaɪd
tethered	ˈtɛðərd
textured	ˈtɛksʧərd
thanked	θæŋkt
thawed	θɔd
thickened	ˈθɪkənd
thinned	θɪnd
thirsted	ˈθɜrstɪd
thought	θɔt
thrashed	θræʃt
threaded	ˈθrɛdəd
threatened	ˈθrɛtənd
threshed	θrɛʃt
threw	θru
thrilled	θrɪld
thrived	θraɪvd
throbbed	θrɑbd
throttled	ˈθrɑtəld
thumbed	θʌmd
thumped	θʌmpt
thundered	ˈθʌndərd
thwarted	ˈθwɔrtəd
ticked	tɪkt
tickled	ˈtɪkəld
tidied	ˈtaɪdid
tied	taɪd
tiered	tird
tightened	ˈtaɪtənd
tiled	taɪld
tilled	tɪld
tilted	ˈtɪltəd
timbered	ˈtɪmbərd
timed	taɪmd
tinkled	ˈtɪŋkəld
tinted	ˈtɪntɪd
tipped	tɪpt
tired	ˈtaɪərd
titled	ˈtaɪtəld
toasted	ˈtoʊstɪd
toiled	tɔɪld
told	toʊld
tolerated	ˈtɑləˌreɪtəd
tolled	toʊld
tongued	tʌŋd
took	tʊk
topped	tɑpt
toppled	ˈtɑpəld
tore	tɔr
tormented	ˈtɔrˌmɛntɪd
tortured	ˈtɔrʧərd
tossed	tɔst
totaled	ˈtoʊtəld
totalled	ˈtoʊtəld
totted	ˈtɑtɪd
touched	tʌʧt
toured	tʊrd
tousled	ˈtaʊzld
towed	toʊd
traced	treɪst
tracked	trækt
traded	ˈtreɪdɪd
traditionalized	trəˈdɪʃənəlaɪzd
trafficked	ˈtræfɪkt
trailed	treɪld
trained	treɪnd
tramped	træmpt
trampled	ˈtræmpəld
transcended	trænˈsɛndɪd
transcribed	trænˈskraɪbd
transfered	trænˈsfɜrd
transferred	trænˈsfɜrd
transformed	trænˈsfɔrmd
transgressed	trænzˈgrɛst
translated	trænˈzleɪtəd
transmitted	trænˈsmɪtɪd
transmuted	trænsˈmjutɪd
transpired	trænˈspaɪərd
transplanted	trænˈsplæntɪd
transported	trænˈspɔrtəd
transposed	trænˈspoʊzd
trapped	træpt
traveled	ˈtrævəld
travelled	ˈtrævəld
traversed	ˈtrævərst
treasured	ˈtrɛʒərd
treated	ˈtritəd
trekked	trɛkt
trembled	ˈtrɛmbəld
trespassed	ˈtrɛˌspæst
tricked	trɪkt
tried	traɪd
triggered	ˈtrɪgərd
trilled	trɪld
trimmed	trɪmd
tripled	ˈtrɪpəld
tripped	trɪpt
trotted	ˈtrɑtəd
troubled	ˈtrʌbəld
trucked	trʌkt
trudged	trʌʤd
truncated	ˈtrʌŋˌkeɪtɪd
trusted	ˈtrʌstɪd
tucked	tʌkt
tugged	tʌgd
tumbled	ˈtʌmbəld
tuned	tund
tunneled	ˈtʌnəld
turned	tɜrnd
tuxedoed	ˌtʌkˈsidoʊd
twigged	twɪgd
twined	twaɪnd
twirled	twɜrld
twisted	ˈtwɪstəd
twitched	twɪʧt
twittered	ˈtwɪtərd
typed	taɪpt
typified	ˈtɪpəˌfaɪd
ulcerated	ˈʌlsəˌreɪtɪd
unabashed	ˌʌnəˈbæʃt
unabated	ˌʌnəˈbeɪtɪd
unabridged	ˌʌnəˈbrɪʤd
unaccompanied	ˌʌnəˈkʌmpənid
unaccustomed	ˌʌnəˈkʌstəmd
unachieved	ʌnəˈʧivd
unacknowledged	ʌnækˈnɑlɪʤd
unacquainted	ʌnəˈkweɪntɪd
unadjusted	ˌʌnəˈʤʌstɪd
unadopted	ʌnəˈdɑptəd
unadorned	ˌʌnəˈdɔrnd
unadulterated	ˌʌnəˈdʌltəˌreɪtɪd
unadvised	ʌnædˈvaɪzd
unaffected	ˌʌnəˈfɛktɪd
unaided	əˈneɪdɪd
unalloyed	əˈnæˌlɔɪd
unamused	ʌnəmˈjuzd
unanalyzed	ʌnˈænəˌlaɪzd
unannounced	ˌʌnəˈnaʊnst
unanswered	ˌʌˈnænsərd
unappreciated	ˌʌnəˈpriʃiˌeɪtɪd
unarmed	əˈnɑrmd
unasked	ʌnˈæskt
unassisted	ˌʌnəˈsɪstɪd
unasterisked	ʌnˈæstərɪskt
unattached	ˌʌnəˈtæʧt
unattended	ənəˈtɛndɪd
unauthorized	əˈnɔθəˌraɪzd
unbalanced	ənˈbælənst
unbiased	ˌʌnˈbaɪəst
unblemished	ənˈblɛmɪʃt
unbounded	ənˈbaʊndɪd
unbridled	ənˈbraɪdəld
unburdened	ənˈbɜrdənd
unburned	ənˈbɜrnd
uncaused	ʌnˈkɑzd
uncertified	ʌnˈsɜrtəˌfaɪd
unchallenged	ənˈʧælɪnʤd
unchanged	ənˈʧeɪnʤd
uncharged	ʌnˈʧɑrʤd
uncharted	ənˈʧɑrtɪd
unchecked	ənˈʧɛkt
unclaimed	ənˈkleɪmd
unclenched	ʌnˈklɛnʧt
unclouded	ʌnˈklaʊdɪd
uncluttered	ənˈklʌtərd
uncolored	ʌnˈkʌlərd
uncomforted	ʌnˈkʌmfərtɪd
uncommitted	ˌʌnkəˈmɪtɪd
unconcerned	ˌʌnkənˈsɜrnd
unconditioned	ʌnkənˈdɪʃənd
unconnected	ˌʌnkəˈnɛktɪd
uncontrolled	ˌʌnkənˈtroʊld
uncorked	ənˈkɔrkt
uncounted	ˌʌnˈkaʊntɪd
uncovered	ənˈkʌvərd
uncurled	ʌnˈkɜrld
undamaged	ˌʌnˈdæməʤd
undated	ˌʌnˈdeɪtɪd
undaunted	ənˈdɔntɪd
undecided	ˌʌndɪˈsaɪdɪd
undeclared	əndɪˈklɛrd
undecorated	ʌnˈdɛkəˌreɪtəd
undedicated	ʌnˈdɛdəkeɪtəd
undefended	ʌndɪˈfɛndəd
undefined	ˌʌndɪˈfaɪnd
undepicted	ʌndɪˈpɪktəd
underdeveloped	ˌʌndərdɪˈvɛləpt
undereducated	ˌʌndəˈrɛʤəkeɪtɪd
underestimated	ˈʌndəˈrɛstəˌmeɪtɪd
undergone	ˌʌndərˈgɔn
underhanded	ˈʌndərˈhændɪd
underlined	ˈʌndərˌlaɪnd
undermanned	ˈʌndərˌmænd
undermentioned	ˈʌndərˌmɛnʃənd
undermined	ˌʌndərˈmaɪnd
underpaid	ˈʌndərˈpeɪd
underpopulated	ˌʌndərˈpɑpjəˌleɪtəd
underprivileged	ˌʌndərˈprɪvləʤd
underrated	əndərˈreɪtɪd
underscored	ˌʌndərˈskɔrd
undersexed	ˌʌndərˈsɛkst
undersized	ˈʌndərˌsaɪzd
understaffed	ˈʌndərˌstæft
understanded	ˌʌndərˈstændɪd
understated	ˈʌndərˌsteɪtɪd
understood	ˌʌndərˈstʊd
underwent	ˌʌndərˈwɛnt
undeserved	ˌʌndɪˈzɜrvd
undetected	ˌʌndɪˈtɛktɪd
undetermined	ˌʌndɪˈtɜrmɪnd
undeterred	ˌʌndɪˈtɜrd
undeveloped	ˌʌndɪˈvɛləpt
undifferentiated	əndɪfəˈrɛnʃiˌeɪtɪd
undigested	ʌnˈdaɪˌʤɛstɪd
undignified	ənˈdɪgnɪˌfaɪd
undiluted	ˌʌndəˈlutɪd
undiminished	ˌʌndəˈmɪnɪʃt
undimmed	ʌnˈdɪmd
undisciplined	ənˈdɪsɪplɪnd
undisclosed	ˌʌndɪˈskloʊzd
undisguised	ˌʌndɪsˈgaɪzd
undismayed	ʌndɪˈsmeɪd
undisputed	ˌʌndɪˈspjutɪd
undistinguished	ˌʌndɪˈstɪŋgwɪʃt
undisturbed	ˌʌndɪˈstɜrbd
undivided	ˌʌndəˈvaɪdɪd
undomesticated	ʌndəˈmɛstəˌkeɪtəd
undreamed	ənˈdrimd
undressed	ənˈdrɛst
undulated	ˈʌnʤəˌleɪtəd
unearned	əˈnɜrnd
unearthed	əˈnɜrθt
uneducated	əˈnɛʤʊˌkeɪtɪd
unemployed	ˌʌnɛmˈplɔɪd
unenlightened	ˌʌnɛnˈlaɪtənd
unequaled	əˈniˌkwʌld
unequalled	əˈnikwəld
unexpected	ˌʌnɪkˈspɛktɪd
unexpended	ʌnɪkˈspɛndɪd
unexplained	ˌʌnɪkˈspleɪnd
unexplored	ˌʌnɪkˈsplɔrd
unfastened	ʌnˈfæsənd
unfeigned	ʌnˈfeɪnd
unfenced	ənˈfɛnst
unfertilized	ʌnˈfɜrtəˌlaɪzd
unfettered	ənˈfɛtərd
unfinished	ənˈfɪnɪʃt
unfixed	ʌnˈfɪkst
unfolded	ənˈfoʊldəd
unformed	ənˈfɔrmd
unfounded	ənˈfaʊndɪd
unfrequented	ʌnˈfrikwəntɪd
unfrosted	ʌnˈfrɔstəd
unfulfilled	ˌʌnfʊlˈfɪld
unfurled	ənˈfɜrld
unfurnished	ʌnˈfɜrnɪʃt
unglazed	ʌnˈgleɪzd
unglued	ənˈglud
ungoverned	ʌnˈgʌvərnd
ungratified	ʌnˈgrætəˌfaɪd
unguarded	ənˈgɑrdɪd
unguided	ʌnˈgaɪdəd
unheated	ʌnˈhitəd
unheeded	ənˈhidɪd
unhinged	ənˈhɪnʤd
unhitched	ənˈhɪʧt
unhurried	ənˈhɜrid
unidentified	ˌʌnaɪˈdɛntəˌfaɪd
unified	ˈjunəˌfaɪd
uniformed	ˈjunəˌfɔrmd
unimpaired	ˌʌnɪmˈpɛrd
unimpressed	ˌʌnɪmˈprɛst
unimproved	ˌʌnɪmˈpruvd
uninfluenced	ʌnˈɪnfluənst
uninformed	ˌʌnɪnˈfɔrmd
uninhibited	ˌʌnɪnˈhɪbɪtɪd
uninitiated	ˌʌnɪˈnɪʃiˌeɪtɪd
uninjured	əˈnɪnʤərd
uninspired	ˌʌnɪnˈspaɪərd
unintended	ˌʌnɪnˈtɛndɪd
uninterested	əˈnɪntrəstəd
uninterrupted	ˌʌnɪntəˈrʌptɪd
uninvited	ˌʌnɪnˈvaɪtɪd
uninvolved	ənɪnˈvɔlvd
united	juˈnaɪtəd
unitized	ˈjunətaɪzd
unjustified	ənˈʤʌstəˌfaɪd
unlaced	ʌnˈleɪst
unlamented	ʌnləˈmɛntɪd
unleashed	ənˈliʃt
unleavened	ʌnˈlɛvənd
unlettered	ʌnˈlɛtərd
unlicensed	ənˈlaɪsənst
unlimited	ənˈlɪmətəd
unlinked	ʌnˈlɪŋkt
unlisted	ənˈlɪstɪd
unloaded	ənˈloʊdəd
unlocked	ənˈlɑkt
unmagnified	ʌnˈmægnəˌfaɪd
unmanaged	ənˈmænɪʤd
unmannered	ʌnˈmænərd
unmarked	ənˈmɑrkt
unmarried	ənˈmɛrid
unmasked	ənˈmæskt
unmatched	ənˈmæʧt
unmated	ʌnˈmeɪtɪd
unmeasured	ʌnˈmɛʒərd
unmitigated	ənˈmɪtəˌgeɪtɪd
unmixed	ənˈmɪkst
unmodified	ʌnˈmɑdəˌfaɪd
unmolested	ˌʌnməˈlɛstɪd
unmotivated	ʌnˈmoʊtəˌveɪtəd
unmoved	ənˈmuvd
unnamed	ənˈneɪmd
unneeded	ənˈnidɪd
unnoticed	ənˈnoʊtɪst
unnourished	ʌnˈnɜrɪʃt
unnumbered	ʌnˈnʌmbərd
unoccupied	əˈnɑkjəˌpaɪd
unopened	əˈnoʊpənd
unpadded	ʌnˈpædəd
unpaid	ənˈpeɪd
unpaired	ʌnˈpɛrd
unparalleled	ənˈpɛrəˌlɛld
unpaved	ʌnˈpeɪvd
unperceived	ʌnpərˈsivd
unperformed	ʌnpərˈfɔrmd
unplowed	ʌnˈplaʊd
unplumbed	ʌnˈplʌmd
unprecedented	ənˈprɛsɪˌdɛntɪd
unprejudiced	ʌnˈprɛʤədəst
unpremeditated	ʌnpriˈmɛdəˌteɪtɪd
unprepared	ˌʌnpriˈpɛrd
unprincipled	ənˈprɪnsəpəld
unprompted	ʌnˈprɑmptəd
unprotected	ˌʌnprəˈtɛktɪd
unproved	ənˈpruvd
unprovoked	ˌʌnprəˈvoʊkt
unpublished	ənˈpʌblɪʃt
unpunished	ənˈpʌnɪʃt
unqualified	ənˈkwɑlɪˌfaɪd
unquenched	ʌnˈkwɛnʧt
unquestioned	ənˈkwɛsʧənd
unrecognized	ənˈrɛkəgˌnaɪzd
unreconstructed	ˌʌnrikənˈstrʌktɪd
unredeemed	ˌʌnriˈdimd
unrehearsed	ənriˈhɜrst
unrelated	ˌʌnrɪˈleɪtɪd
unreleased	ənrɪˈlist
unrelieved	ˌʌnriˈlivd
unrequited	ˌʌnriˈkwaɪtɪd
unreserved	ʌnrɪˈzɜrvd
unresolved	ənrɪˈzɑlvd
unrestrained	ˌʌnriˈstreɪnd
unrestricted	ˌʌnriˈstrɪktɪd
unrifled	ʌnˈraɪfəld
unrivalled	ʌnˈraɪvəld
unrolled	ʌnˈroʊld
unruffled	ənˈrʌfəld
unsaid	ənˈsɛd
unsalted	ʌnˈsɔltəd
unsaturated	ənˈsæʧəˌreɪtɪd
unscathed	ənˈskeɪðd
unschooled	ʌnˈskuld
unscrewed	ʌnˈskrud
unscripted	ənˈskrɪptɪd
unsealed	ənˈsild
unseasoned	ʌnˈsizənd
unsettled	ənˈsɛtəld
unsharpened	ənˈʃɑrpənd
unshaved	ʌnˈʃeɪvd
unshielded	ʌnˈʃildɪd
unsigned	ənˈsaɪnd
unskilled	ənˈskɪld
unsloped	ʌnˈsloʊpt
unsolved	ənˈsɑlvd
unsophisticated	ˌʌnsəˈfɪstɪˌkeɪtɪd
unspecified	ənˈspɛsəˌfaɪd
unspotted	ʌnˈspɑtəd
unstained	ənˈsteɪnd
unstapled	ʌnˈsteɪpəld
unstilted	ʌnˈstɪltɪd
unstressed	ʌnˈstrɛst
unstructured	ənˈstrʌkʃərd
unstudied	ʌnˈstʌdid
unsuited	ənˈsutɪd
unsullied	ənˈsʌlid
unsupported	ənsəˈpɔrtɪd
unsurpassed	ˌʌnsərˈpæst
untapped	ənˈtæpt
untenanted	ʌnˈtɛnəntɪd
untied	ənˈtaɪd
untouched	ənˈtʌʧt
untracked	ʌnˈtrækt
untrained	ənˈtreɪnd
untreated	ənˈtritɪd
unused	ənˈjuzd
unuttered	ʌnˈʌtərd
unvarnished	ənˈvɑrnɪʃt
unveiled	ənˈveɪld
unventilated	ʌnˈvɛntəˌleɪtɪd
unversed	ʌnˈvɜrst
unvoiced	ʌnˈvɔɪst
unwanted	ənˈwɔntɪd
unwarranted	ənˈwɔrəntɪd
unwired	ʌnˈwaɪərd
unwonted	ʌnˈwoʊntɪd
unwounded	ənˈwaʊndɪd
unwrinkled	ʌnˈrɪŋkəld
upholstered	əˈpoʊlstərd
upped	ʌpt
urbanized	ˈɜrbəˌnaɪzd
urged	ɜrʤd
ushered	ˈʌʃərd
usurped	ˌjuˈsɜrpt
utilized	ˈjutəˌlaɪzd
uttered	ˈʌtərd
vacated	veɪˈkeɪtəd
vacuumed	ˈvækjumd
validated	ˈvælədeɪtəd
valued	ˈvæljud
vanished	ˈvænɪʃt
varied	ˈvɛrid
veered	vɪrd
veiled	veɪld
veined	veɪnd
venerated	ˈvɛnəˌreɪtɪd
vented	ˈvɛntɪd
ventilated	ˈvɛntəˌleɪtɪd
ventured	ˈvɛnʧərd
verified	ˈvɛrəˌfaɪd
versed	vɜrst
vested	ˈvɛstəd
vetoed	ˈvitoʊd
vexed	vɛkst
vibrated	ˈvaɪbreɪtɪd
victimized	ˈvɪktəmaɪzd
vied	vaɪd
viewed	vjud
vindicated	ˈvɪndəkeɪtɪd
violated	ˈvaɪəleɪtɪd
visited	ˈvɪzətəd
visualized	ˈvɪʒwəˌlaɪzd
vivified	ˈvɪvəˌfaɪd
voiced	vɔɪst
volunteered	ˌvɑlənˈtɪrd
voted	ˈvoʊtəd
vowed	vaʊd
vulcanized	ˈvʌlkənaɪzd
wadded	ˈwɑdəd
waded	ˈweɪdɪd
waged	weɪʤd
wagged	wægd
waggled	ˈwæɡəld
wailed	weɪld
wainscoted	ˈweɪnskətɪd
waited	ˈweɪtəd
waived	weɪvd
waked	weɪkt
wakened	ˈweɪkənd
walked	wɔkt
walled	wɔld
walloped	ˈwɑləpt
wallowed	ˈwɑloʊd
wandered	ˈwɑndərd
waned	weɪnd
wanted	ˈwɑntəd
warmed	wɔrmd
warned	wɔrnd
warped	wɔrpt
warranted	ˈwɔrəntɪd
warred	wɔrd
washed	wɑʃt
wasted	ˈweɪstəd
watched	wɑʧt
watered	ˈwɔtərd
waved	weɪvd
waxed	wækst
weakened	ˈwikənd
weaned	wind
wearied	ˈwɪrid
weathered	ˈwɛðərd
wedded	ˈwɛdəd
wedged	wɛʤd
weeded	ˈwidɪd
weighed	weɪd
weighted	ˈweɪtɪd
welcomed	ˈwɛlkəmd
welded	ˈwɛldɪd
welled	wɛld
went	wɛnt
wept	wɛpt
whacked	wækt
wheeled	wild
wheezed	wizd
whetted	ˈwɛtɪd
whined	waɪnd
whinnied	ˈwɪnid
whipped	wɪpt
whirled	wɜrld
whisked	wɪskt
whiskered	ˈwɪskərd
whispered	ˈwɪspərd
whistled	ˈwɪsəld
whitened	ˈwaɪtənd
whizzed	wɪzd
widened	ˈwaɪdənd
widowed	ˈwɪdoʊd
wielded	ˈwildɪd
wiggled	ˈwɪgəld
willed	wɪld
wilted	ˈwɪltɪd
winced	wɪnst
winded	ˈwɪndɪd
winged	wɪŋd
winked	wɪŋkt
wintered	ˈwɪntərd
wiped	waɪpt
wired	ˈwaɪərd
wished	wɪʃt
withered	ˈwɪðərd
witnessed	ˈwɪtnəst
wobbled	ˈwɑbəld
woke	woʊk
won	wʌn
wondered	ˈwʌndərd
wooded	ˈwʊdɪd
wooed	wud
worded	ˈwɜrdɪd
wore	wɔr
worked	wɜrkt
worried	ˈwɜrid
worsened	ˈwɜrsənd
worshipped	ˈwɜrʃəpt
worsted	ˈwɜrstɪd
wound	wund
wounded	ˈwundəd
wove	woʊv
woven	ˈwoʊvən
wrangled	ˈræŋgəld
wrapped	ræpt
wreathed	riθt
wrecked	rɛkt
wrenched	rɛnʧt
wretched	ˈrɛʧɪd
wrinkled	ˈrɪŋkəld
writhed	rɪθt
written	ˈrɪtən
wronged	rɔŋd
wrote	roʊt
yanked	jæŋkt
yearned	jɜrnd
yelled	jɛld
yellowed	ˈjɛloʊd
yelped	jɛlpt
yielded	ˈjildəd
zeroed	ˈzɪroʊd
zipped	zɪpt
zoned	zoʊnd
